mr	
"name[Blue Spice], eatType[coffee shop], area[city centre]"	"If you are looking for a coffee shop in the city centre, Blue Spice is a good option. It has an average customer rating."
"name[Blue Spice], eatType[coffee shop], area[riverside]"	Coffee shop Blue Spice is located in the riverside area and has a customer rating of 3 out of 5.
"name[Blue Spice], eatType[coffee shop], customer rating[5 out of 5], near[Crowne Plaza Hotel]"	There is a coffee shop near Crowne Plaza Hotel called Blue Spice. It has a customer rating of 5 out of 5.
"name[Blue Spice], eatType[coffee shop], customer rating[average], near[Burger King]"	"If you are looking for a coffee shop with an average customer rating, try Blue Spice. It is located near Burger King."
"name[Blue Spice], eatType[coffee shop], customer rating[average], near[Crowne Plaza Hotel]"	"If you are looking for a coffee shop with an average customer rating, try Blue Spice. It is located near Crowne Plaza Hotel."
"name[Blue Spice], eatType[pub], area[city centre]"	"If you are looking for a pub in the city centre, try Blue Spice."
"name[Blue Spice], eatType[pub], area[riverside]"	"If you are looking for a pub in the riverside area, try Blue Spice."
"name[Blue Spice], eatType[pub], customer rating[5 out of 5], near[Crowne Plaza Hotel]"	Come to Blue Spice pub near Crowne Plaza Hotel.  It has a customer rating of 5 out of 5.
"name[Blue Spice], eatType[pub], customer rating[average], near[Burger King]"	"If you are looking for a pub near Burger King, try Blue Spice. It has an average customer rating."
"name[Blue Spice], eatType[pub], customer rating[average], near[Crowne Plaza Hotel]"	"If you are looking for a pub near Crowne Plaza Hotel, try Blue Spice. It has an average customer rating."
"name[Blue Spice], eatType[pub], food[Chinese], area[city centre], familyFriendly[no], near[Rainbow Vegetarian CafÃ©]"	A pub near Rainbow Vegetarian Café in the city centre is Blue Spice. It serves Chinese food and is not family-friendly.
"name[Blue Spice], eatType[pub], food[Chinese], area[city centre], familyFriendly[yes], near[Rainbow Vegetarian CafÃ©]"	"Serving Chinese food in a family-friendly environment, Blue Spice is a pub located in the city centre near Rainbow Vegetarian Café."
"name[Blue Spice], eatType[pub], food[Chinese], area[riverside], familyFriendly[no], near[Rainbow Vegetarian CafÃ©]"	On the riverside near Rainbow Vegetarian Café is a pub called Blue Spice. It serves Chinese food and is not family-friendly.
"name[Blue Spice], eatType[pub], food[Chinese], area[riverside], familyFriendly[yes], near[Rainbow Vegetarian CafÃ©]"	By the riverside near Rainbow Vegetarian Café is a pub called Blue Spice. It serves Chinese food and is children friendly.
"name[Blue Spice], eatType[pub], food[English], area[city centre], familyFriendly[no], near[Rainbow Vegetarian CafÃ©]"	A pub near Rainbow Vegetarian Café in the city centre is Blue Spice. It serves English food and is not family-friendly.
"name[Blue Spice], eatType[pub], food[English], area[city centre], familyFriendly[yes], near[Rainbow Vegetarian CafÃ©]"	"Serving English food in a family-friendly environment, Blue Spice is a pub located in the city centre near Rainbow Vegetarian Café."
"name[Blue Spice], eatType[pub], food[English], area[riverside], familyFriendly[no], near[Rainbow Vegetarian CafÃ©]"	On the riverside near Rainbow Vegetarian Café is a pub called Blue Spice. It serves English food and is not family-friendly.
"name[Blue Spice], eatType[pub], food[English], area[riverside], familyFriendly[yes], near[Rainbow Vegetarian CafÃ©]"	By the riverside near Rainbow Vegetarian Café is a pub called Blue Spice. It serves English food and is children friendly.
"name[Blue Spice], eatType[restaurant], food[Chinese], area[city centre], familyFriendly[no], near[Rainbow Vegetarian CafÃ©]"	"Serving Chinese food, Blue Spice is a restaurant near Rainbow Vegetarian Café in the city centre. It is not family-friendly."
"name[Blue Spice], eatType[restaurant], food[Chinese], area[city centre], familyFriendly[yes], near[Rainbow Vegetarian CafÃ©]"	Children friendly Blue Spice restaurant serves Chinese food and is located in the city centre near Rainbow Vegetarian Café.
"name[Blue Spice], eatType[restaurant], food[Chinese], area[riverside], familyFriendly[no], near[Rainbow Vegetarian CafÃ©]"	Blue Spice is a restaurant that serves Chinese food in the riverside area near Rainbow Vegetarian Café. It is not family friendly.
"name[Blue Spice], eatType[restaurant], food[Chinese], area[riverside], familyFriendly[yes], near[Rainbow Vegetarian CafÃ©]"	Children friendly Chinese restaurant Blue Spice is located in riverside near Rainbow Vegetarian Café.
"name[Blue Spice], eatType[restaurant], food[English], area[city centre], familyFriendly[no], near[Rainbow Vegetarian CafÃ©]"	"Serving English food, Blue Spice is a restaurant near Rainbow Vegetarian Café in the city centre. It is not family-friendly."
"name[Blue Spice], eatType[restaurant], food[English], area[city centre], familyFriendly[yes], near[Rainbow Vegetarian CafÃ©]"	Children friendly Blue Spice restaurant serves English food and is located in the city centre near Rainbow Vegetarian Café.
"name[Blue Spice], eatType[restaurant], food[English], area[riverside], familyFriendly[no], near[Rainbow Vegetarian CafÃ©]"	Blue Spice is a restaurant that serves English food in the riverside area near Rainbow Vegetarian Café. It is not family friendly.
"name[Blue Spice], eatType[restaurant], food[English], area[riverside], familyFriendly[yes], near[Rainbow Vegetarian CafÃ©]"	Children friendly English restaurant Blue Spice is located in riverside near Rainbow Vegetarian Café.
"name[Clowns], eatType[coffee shop], customer rating[3 out of 5], near[All Bar One]"	Coffee shop called Clowns is near All Bar One and has a customer rating of 3 out of 5.
"name[Clowns], eatType[coffee shop], customer rating[5 out of 5], near[Crowne Plaza Hotel]"	There is a coffee shop near Crowne Plaza Hotel called Clowns. It has a customer rating of 5 out of 5.
"name[Clowns], eatType[coffee shop], near[The Sorrento]"	Coffee shop called Clowns is near The Sorrento.
"name[Clowns], eatType[pub], customer rating[3 out of 5], near[All Bar One]"	"Situated near All Bar One, Clowns is a pub with a customer rating of 3 out of 5."
"name[Clowns], eatType[pub], customer rating[5 out of 5], near[Crowne Plaza Hotel]"	Come to Clowns pub near Crowne Plaza Hotel.  It has a customer rating of 5 out of 5.
"name[Clowns], eatType[pub], near[The Sorrento]"	"If you are looking for a pub near The Sorrento, try Clowns."
"name[Cocum], eatType[coffee shop], customer rating[high], near[Burger King]"	"If you are looking for a highly rated coffee shop near Burger King, try Cocum."
"name[Cocum], eatType[coffee shop], customer rating[high], near[CafÃ© Sicilia]"	"If you are looking for a highly rated coffee shop near Café Sicilia, try Cocum."
"name[Cocum], eatType[coffee shop], customer rating[low], near[CafÃ© Sicilia]"	The Cocum is a coffee shop near Café Sicilia with a low customer rating.
"name[Cocum], eatType[coffee shop], customer rating[low], near[Express by Holiday Inn]"	The Cocum is a coffee shop near Express by Holiday Inn with a low customer rating.
"name[Cocum], eatType[coffee shop], near[The Rice Boat]"	Coffee shop called Cocum is near The Rice Boat.
"name[Cocum], eatType[coffee shop], near[The Sorrento]"	Coffee shop called Cocum is near The Sorrento.
"name[Cocum], eatType[pub], customer rating[high], near[Burger King]"	"Check out Cocum, a pub near Burger King. It has a high customer rating."
"name[Cocum], eatType[pub], customer rating[high], near[CafÃ© Sicilia]"	"Check out Cocum, a pub near Café Sicilia. It has a high customer rating."
"name[Cocum], eatType[pub], customer rating[low], near[CafÃ© Sicilia]"	"With a low customer rating, Cocum is a pub near Café Sicilia."
"name[Cocum], eatType[pub], customer rating[low], near[Express by Holiday Inn]"	"With a low customer rating, Cocum is a pub near Express by Holiday Inn."
"name[Cocum], eatType[pub], near[The Rice Boat]"	"If you are looking for a pub near The Rice Boat, try Cocum."
"name[Cocum], eatType[pub], near[The Sorrento]"	"If you are looking for a pub near The Sorrento, try Cocum."
"name[Cotto], eatType[coffee shop], near[The Bakers]"	Coffee shop called Cotto is near The Bakers.
"name[Cotto], eatType[pub], near[The Bakers]"	"If you are looking for a pub near The Bakers, try Cotto."
"name[Giraffe], eatType[coffee shop], near[The Bakers]"	Coffee shop called Giraffe is near The Bakers.
"name[Giraffe], eatType[coffee shop], near[The Rice Boat]"	Coffee shop called Giraffe is near The Rice Boat.
"name[Giraffe], eatType[pub], food[English], area[riverside], familyFriendly[yes], near[Rainbow Vegetarian CafÃ©]"	By the riverside near Rainbow Vegetarian Café is a pub called Giraffe. It serves English food and is children friendly.
"name[Giraffe], eatType[pub], food[Fast food], area[city centre], familyFriendly[no], near[Rainbow Vegetarian CafÃ©]"	A pub near Rainbow Vegetarian Café in the city centre is Giraffe. It serves Fast food food and is not family-friendly.
"name[Giraffe], eatType[pub], food[Fast food], area[city centre], familyFriendly[yes], near[Rainbow Vegetarian CafÃ©]"	"Serving Fast food food in a family-friendly environment, Giraffe is a pub located in the city centre near Rainbow Vegetarian Café."
"name[Giraffe], eatType[pub], food[Fast food], area[riverside], familyFriendly[no], near[Rainbow Vegetarian CafÃ©]"	On the riverside near Rainbow Vegetarian Café is a pub called Giraffe. It serves Fast food food and is not family-friendly.
"name[Giraffe], eatType[pub], food[Fast food], area[riverside], familyFriendly[yes], near[Rainbow Vegetarian CafÃ©]"	By the riverside near Rainbow Vegetarian Café is a pub called Giraffe. It serves Fast food food and is children friendly.
"name[Giraffe], eatType[pub], food[Fast food], area[riverside], familyFriendly[yes], near[Raja Indian Cuisine]"	By the riverside near Raja Indian Cuisine is a pub called Giraffe. It serves Fast food food and is children friendly.
"name[Giraffe], eatType[pub], food[French], area[city centre], familyFriendly[no], near[Raja Indian Cuisine]"	A pub near Raja Indian Cuisine in the city centre is Giraffe. It serves French food and is not family-friendly.
"name[Giraffe], eatType[pub], food[French], area[city centre], familyFriendly[yes], near[Raja Indian Cuisine]"	"Serving French food in a family-friendly environment, Giraffe is a pub located in the city centre near Raja Indian Cuisine."
"name[Giraffe], eatType[pub], food[French], area[riverside], familyFriendly[no], near[Raja Indian Cuisine]"	On the riverside near Raja Indian Cuisine is a pub called Giraffe. It serves French food and is not family-friendly.
"name[Giraffe], eatType[pub], food[French], area[riverside], familyFriendly[yes], near[Raja Indian Cuisine]"	By the riverside near Raja Indian Cuisine is a pub called Giraffe. It serves French food and is children friendly.
"name[Giraffe], eatType[pub], near[The Bakers]"	"If you are looking for a pub near The Bakers, try Giraffe."
"name[Giraffe], eatType[pub], near[The Rice Boat]"	"If you are looking for a pub near The Rice Boat, try Giraffe."
"name[Giraffe], eatType[restaurant], food[English], area[riverside], familyFriendly[yes], near[Rainbow Vegetarian CafÃ©]"	Children friendly English restaurant Giraffe is located in riverside near Rainbow Vegetarian Café.
"name[Giraffe], eatType[restaurant], food[Fast food], area[city centre], familyFriendly[no], near[Rainbow Vegetarian CafÃ©]"	"Serving Fast food food, Giraffe is a restaurant near Rainbow Vegetarian Café in the city centre. It is not family-friendly."
"name[Giraffe], eatType[restaurant], food[Fast food], area[city centre], familyFriendly[yes], near[Rainbow Vegetarian CafÃ©]"	Children friendly Giraffe restaurant serves Fast food food and is located in the city centre near Rainbow Vegetarian Café.
"name[Giraffe], eatType[restaurant], food[Fast food], area[riverside], familyFriendly[no], near[Rainbow Vegetarian CafÃ©]"	Giraffe is a restaurant that serves Fast food food in the riverside area near Rainbow Vegetarian Café. It is not family friendly.
"name[Giraffe], eatType[restaurant], food[Fast food], area[riverside], familyFriendly[yes], near[Rainbow Vegetarian CafÃ©]"	Children friendly Fast food restaurant Giraffe is located in riverside near Rainbow Vegetarian Café.
"name[Giraffe], eatType[restaurant], food[Fast food], area[riverside], familyFriendly[yes], near[Raja Indian Cuisine]"	Children friendly Fast food restaurant Giraffe is located in riverside near Raja Indian Cuisine.
"name[Giraffe], eatType[restaurant], food[French], area[city centre], familyFriendly[no], near[Raja Indian Cuisine]"	"Serving French food, Giraffe is a restaurant near Raja Indian Cuisine in the city centre. It is not family-friendly."
"name[Giraffe], eatType[restaurant], food[French], area[city centre], familyFriendly[yes], near[Raja Indian Cuisine]"	Children friendly Giraffe restaurant serves French food and is located in the city centre near Raja Indian Cuisine.
"name[Giraffe], eatType[restaurant], food[French], area[riverside], familyFriendly[no], near[Raja Indian Cuisine]"	Giraffe is a restaurant that serves French food in the riverside area near Raja Indian Cuisine. It is not family friendly.
"name[Giraffe], eatType[restaurant], food[French], area[riverside], familyFriendly[yes], near[Raja Indian Cuisine]"	Children friendly French restaurant Giraffe is located in riverside near Raja Indian Cuisine.
"name[Green Man], eatType[coffee shop], customer rating[1 out of 5], near[All Bar One]"	"Situated near All Bar One, Green Man is a coffee shop with a customer rating of 1 out of 5."
"name[Green Man], eatType[coffee shop], customer rating[3 out of 5], near[All Bar One]"	Coffee shop called Green Man is near All Bar One and has a customer rating of 3 out of 5.
"name[Green Man], eatType[pub], customer rating[1 out of 5], near[All Bar One]"	"Situated near All Bar One, Green Man is a pub with a customer rating of 1 out of 5."
"name[Green Man], eatType[pub], customer rating[3 out of 5], near[All Bar One]"	"Situated near All Bar One, Green Man is a pub with a customer rating of 3 out of 5."
"name[Green Man], eatType[pub], food[Italian], area[riverside], familyFriendly[yes], near[Express by Holiday Inn]"	By the riverside near Express by Holiday Inn is a pub called Green Man. It serves Italian food and is children friendly.
"name[Green Man], eatType[pub], food[Italian], area[riverside], familyFriendly[yes], near[Raja Indian Cuisine]"	By the riverside near Raja Indian Cuisine is a pub called Green Man. It serves Italian food and is children friendly.
"name[Green Man], eatType[pub], food[Japanese], area[city centre], familyFriendly[no], near[Express by Holiday Inn]"	A pub near Express by Holiday Inn in the city centre is Green Man. It serves Japanese food and is not family-friendly.
"name[Green Man], eatType[pub], food[Japanese], area[city centre], familyFriendly[yes], near[Express by Holiday Inn]"	"Serving Japanese food in a family-friendly environment, Green Man is a pub located in the city centre near Express by Holiday Inn."
"name[Green Man], eatType[pub], food[Japanese], area[riverside], familyFriendly[no], near[Express by Holiday Inn]"	On the riverside near Express by Holiday Inn is a pub called Green Man. It serves Japanese food and is not family-friendly.
"name[Green Man], eatType[pub], food[Japanese], area[riverside], familyFriendly[yes], near[Express by Holiday Inn]"	By the riverside near Express by Holiday Inn is a pub called Green Man. It serves Japanese food and is children friendly.
"name[Green Man], eatType[restaurant], food[Italian], area[riverside], familyFriendly[yes], near[Express by Holiday Inn]"	Children friendly Italian restaurant Green Man is located in riverside near Express by Holiday Inn.
"name[Green Man], eatType[restaurant], food[Italian], area[riverside], familyFriendly[yes], near[Raja Indian Cuisine]"	Children friendly Italian restaurant Green Man is located in riverside near Raja Indian Cuisine.
"name[Green Man], eatType[restaurant], food[Japanese], area[city centre], familyFriendly[no], near[Express by Holiday Inn]"	"Serving Japanese food, Green Man is a restaurant near Express by Holiday Inn in the city centre. It is not family-friendly."
"name[Green Man], eatType[restaurant], food[Japanese], area[city centre], familyFriendly[yes], near[Express by Holiday Inn]"	Children friendly Green Man restaurant serves Japanese food and is located in the city centre near Express by Holiday Inn.
"name[Green Man], eatType[restaurant], food[Japanese], area[riverside], familyFriendly[no], near[Express by Holiday Inn]"	Green Man is a restaurant that serves Japanese food in the riverside area near Express by Holiday Inn. It is not family friendly.
"name[Green Man], eatType[restaurant], food[Japanese], area[riverside], familyFriendly[yes], near[Express by Holiday Inn]"	Children friendly Japanese restaurant Green Man is located in riverside near Express by Holiday Inn.
"name[Loch Fyne], eatType[coffee shop], area[riverside]"	Coffee shop Loch Fyne is located in the riverside area and has a customer rating of 3 out of 5.
"name[Loch Fyne], eatType[pub], area[riverside]"	"If you are looking for a pub in the riverside area, try Loch Fyne."
"name[Strada], eatType[coffee shop], area[city centre]"	"If you are looking for a coffee shop in the city centre, Strada is a good option. It has an average customer rating."
"name[Strada], eatType[coffee shop], customer rating[1 out of 5], near[All Bar One]"	"Situated near All Bar One, Strada is a coffee shop with a customer rating of 1 out of 5."
"name[Strada], eatType[coffee shop], customer rating[1 out of 5], near[Rainbow Vegetarian CafÃ©]"	"Situated near Rainbow Vegetarian Café, Strada is a coffee shop with a customer rating of 1 out of 5."
"name[Strada], eatType[coffee shop], customer rating[low], near[Express by Holiday Inn]"	The Strada is a coffee shop near Express by Holiday Inn with a low customer rating.
"name[Strada], eatType[pub], area[city centre]"	"If you are looking for a pub in the city centre, try Strada."
"name[Strada], eatType[pub], customer rating[1 out of 5], near[All Bar One]"	"Situated near All Bar One, Strada is a pub with a customer rating of 1 out of 5."
"name[Strada], eatType[pub], customer rating[1 out of 5], near[Rainbow Vegetarian CafÃ©]"	"Situated near Rainbow Vegetarian Café, Strada is a pub with a customer rating of 1 out of 5."
"name[Strada], eatType[pub], customer rating[low], near[Express by Holiday Inn]"	"With a low customer rating, Strada is a pub near Express by Holiday Inn."
"name[The Cricketers], eatType[coffee shop], customer rating[1 out of 5], familyFriendly[yes], near[Avalon]"	"Yes, there is a coffee shop near Avalon called The Cricketers. It is children friendly and has a customer rating of 1 out of 5."
"name[The Cricketers], eatType[coffee shop], customer rating[3 out of 5], familyFriendly[yes], near[Avalon]"	"Situated near Avalon, The Cricketers is a child friendly coffee shop with a customer rating of 3 out of 5."
"name[The Cricketers], eatType[coffee shop], customer rating[3 out of 5], familyFriendly[yes], near[Crowne Plaza Hotel]"	"Situated near Crowne Plaza Hotel, The Cricketers is a child friendly coffee shop with a customer rating of 3 out of 5."
"name[The Cricketers], eatType[coffee shop], customer rating[5 out of 5], familyFriendly[no], near[Crowne Plaza Hotel]"	A coffee shop near Crowne Plaza Hotel with a customer rating of 5 out of 5 is The Cricketers. It is not family-friendly.
"name[The Cricketers], eatType[coffee shop], customer rating[5 out of 5], familyFriendly[yes], near[Crowne Plaza Hotel]"	Children friendly The Cricketers is a coffee shop near Crowne Plaza Hotel with a customer rating of 5 out of 5.
"name[The Cricketers], eatType[coffee shop], customer rating[average], familyFriendly[no], near[CafÃ© Sicilia]"	"Although not family-friendly, The Cricketers coffee shop is near Café Sicilia and has an average customer rating."
"name[The Cricketers], eatType[coffee shop], customer rating[average], familyFriendly[no], near[Crowne Plaza Hotel]"	"Although not family-friendly, The Cricketers coffee shop is near Crowne Plaza Hotel and has an average customer rating."
"name[The Cricketers], eatType[coffee shop], customer rating[average], familyFriendly[yes], near[CafÃ© Sicilia]"	"If you are looking for a children friendly coffee shop with an average customer rating, try The Cricketers, near Café Sicilia."
"name[The Cricketers], eatType[coffee shop], customer rating[high], familyFriendly[yes], near[CafÃ© Sicilia]"	Close to Café Sicilia is a child friendly coffee shop called The Cricketers. It has a high customer rating.
"name[The Cricketers], eatType[coffee shop], customer rating[high], familyFriendly[yes], near[Express by Holiday Inn]"	Close to Express by Holiday Inn is a child friendly coffee shop called The Cricketers. It has a high customer rating.
"name[The Cricketers], eatType[coffee shop], customer rating[low], familyFriendly[no], near[Express by Holiday Inn]"	"Although not family-friendly, The Cricketers is a coffee shop near Express by Holiday Inn. It has a low customer rating."
"name[The Cricketers], eatType[coffee shop], customer rating[low], familyFriendly[no], near[Ranch]"	"Although not family-friendly, The Cricketers is a coffee shop near Ranch. It has a low customer rating."
"name[The Cricketers], eatType[coffee shop], customer rating[low], familyFriendly[yes], near[Ranch]"	"Come to The Cricketers, a family friendly coffee shop near Ranch.  It has a low customer rating."
"name[The Cricketers], eatType[restaurant], customer rating[1 out of 5], familyFriendly[yes], near[Avalon]"	The The Cricketers restaurant is a child friendly restaurant with a customer rating of 1 out of 5 near Avalon.
"name[The Cricketers], eatType[restaurant], customer rating[3 out of 5], familyFriendly[yes], near[Avalon]"	The The Cricketers restaurant is a 3 out of 5 rated kid friendly restaurant near Avalon
"name[The Cricketers], eatType[restaurant], customer rating[3 out of 5], familyFriendly[yes], near[Crowne Plaza Hotel]"	The The Cricketers restaurant is a 3 out of 5 rated kid friendly restaurant near Crowne Plaza Hotel
"name[The Cricketers], eatType[restaurant], customer rating[5 out of 5], familyFriendly[no], near[Crowne Plaza Hotel]"	The The Cricketers restaurant is near Crowne Plaza Hotel and has a customer rating of 5 out of 5.  It is not family-friendly.
"name[The Cricketers], eatType[restaurant], customer rating[5 out of 5], familyFriendly[yes], near[Crowne Plaza Hotel]"	The The Cricketers restaurant is located near Crowne Plaza Hotel. It is family friendly and has a customer rating of 5 out of 5.
"name[The Cricketers], eatType[restaurant], customer rating[average], familyFriendly[no], near[CafÃ© Sicilia]"	The Cricketers is a restaurant near Café Sicilia with an average customer rating. It is not family-friendly.
"name[The Cricketers], eatType[restaurant], customer rating[average], familyFriendly[no], near[Crowne Plaza Hotel]"	The Cricketers is a restaurant near Crowne Plaza Hotel with an average customer rating. It is not family-friendly.
"name[The Cricketers], eatType[restaurant], customer rating[average], familyFriendly[yes], near[CafÃ© Sicilia]"	A restaurant named The Cricketers is located near Café Sicilia. It has an average customer rating and is children friendly.
"name[The Cricketers], eatType[restaurant], customer rating[high], familyFriendly[yes], near[CafÃ© Sicilia]"	The The Cricketers restaurant is a child friendly restaurant with a high customer rating near Café Sicilia.
"name[The Cricketers], eatType[restaurant], customer rating[high], familyFriendly[yes], near[Express by Holiday Inn]"	The The Cricketers restaurant is a child friendly restaurant with a high customer rating near Express by Holiday Inn.
"name[The Cricketers], eatType[restaurant], customer rating[low], familyFriendly[no], near[Express by Holiday Inn]"	The Cricketers is a restaurant near Express by Holiday Inn with a low customer rating. It is not family-friendly.
"name[The Cricketers], eatType[restaurant], customer rating[low], familyFriendly[no], near[Ranch]"	The Cricketers is a restaurant near Ranch with a low customer rating. It is not family-friendly.
"name[The Cricketers], eatType[restaurant], customer rating[low], familyFriendly[yes], near[Ranch]"	"For a family friendly restaurant near Ranch, try The Cricketers. It has a low customer rating."
"name[The Cricketers], eatType[restaurant], food[Chinese], priceRange[Â£20-25], customer rating[high], area[city centre], familyFriendly[no], near[All Bar One]"	A high rated Chinese restaurant in the city centre near All Bar One is The Cricketers. It is not kid friendly and has a price range of £20-25.
"name[The Cricketers], eatType[restaurant], food[Chinese], priceRange[Â£20-25], customer rating[high], area[city centre], familyFriendly[yes], near[All Bar One]"	A high rated Chinese restaurant in the city centre near All Bar One is The Cricketers. It is kids friendly and has a price range of £20-25.
"name[The Cricketers], eatType[restaurant], food[Chinese], priceRange[Â£20-25], customer rating[high], area[riverside], familyFriendly[no], near[All Bar One]"	There is a high rated Chinese restaurant near All Bar One called The Cricketers which is not kid friendly and has a price range of £20-25.
"name[The Cricketers], eatType[restaurant], food[Chinese], priceRange[Â£20-25], customer rating[high], area[riverside], familyFriendly[yes], near[All Bar One]"	High rated Chinese restaurant The Cricketers is located in the riverside area near All Bar One. It is kid friendly.
"name[The Cricketers], eatType[restaurant], food[Chinese], priceRange[cheap], customer rating[5 out of 5], area[city centre], familyFriendly[no], near[All Bar One]"	The The Cricketers restaurant is a cheap Chinese restaurant located in the city centre near All Bar One.  It has a customer rating of 5 out of 5 and is not family-friendly.
"name[The Cricketers], eatType[restaurant], food[Chinese], priceRange[cheap], customer rating[5 out of 5], area[city centre], familyFriendly[yes], near[All Bar One]"	"For a cheap Chinese restaurant in the city centre near All Bar One, try The Cricketers. It is family friendly."
"name[The Cricketers], eatType[restaurant], food[Chinese], priceRange[cheap], customer rating[5 out of 5], area[riverside], familyFriendly[no], near[All Bar One]"	Riverside restaurant The Cricketers is a cheap Chinese restaurant with a customer rating of 5 out of 5. It is not family friendly.
"name[The Cricketers], eatType[restaurant], food[Chinese], priceRange[cheap], customer rating[5 out of 5], area[riverside], familyFriendly[yes], near[All Bar One]"	This restaurant is located in the riverside area near the All Bar One.  It is called The Cricketers and is family friendly.  It serves Chinese food and has a cheap price range.
"name[The Cricketers], eatType[restaurant], food[Chinese], priceRange[cheap], customer rating[average], area[city centre], familyFriendly[no], near[All Bar One]"	The The Cricketers restaurant is a cheap Chinese restaurant located in the city centre near the All Bar One. It has an average customer rating and is not family-friendly.
"name[The Cricketers], eatType[restaurant], food[Chinese], priceRange[cheap], customer rating[average], area[city centre], familyFriendly[yes], near[All Bar One]"	"For a cheap Chinese restaurant in the city centre near All Bar One, The Cricketers is a great place to eat. It is family friendly."
"name[The Cricketers], eatType[restaurant], food[Chinese], priceRange[cheap], customer rating[average], area[riverside], familyFriendly[no], near[All Bar One]"	The The Cricketers restaurant is a cheap fast food restaurant located in riverside near All Bar One.  It has an average customer rating and is not family friendly.
"name[The Cricketers], eatType[restaurant], food[Chinese], priceRange[cheap], customer rating[average], area[riverside], familyFriendly[yes], near[All Bar One]"	Cheap family friendly restaurant The Cricketers is located in the riverside area near All Bar One. It has an average customer rating.
"name[The Cricketers], eatType[restaurant], food[Chinese], priceRange[high], customer rating[1 out of 5], area[city centre], familyFriendly[no], near[All Bar One]"	Chinese restaurant The Cricketers is located in the city centre near All Bar One. It is not children friendly and is in the high price range.
"name[The Cricketers], eatType[restaurant], food[Chinese], priceRange[high], customer rating[1 out of 5], area[city centre], familyFriendly[yes], near[All Bar One]"	There is a high priced Chinese restaurant called The Cricketers located in the city centre near All Bar One with a customer rating of 1 out of 5.
"name[The Cricketers], eatType[restaurant], food[Chinese], priceRange[high], customer rating[1 out of 5], area[riverside], familyFriendly[no], near[All Bar One]"	High priced Chinese restaurant The Cricketers is located in the riverside area near All Bar One. It is not child friendly.
"name[The Cricketers], eatType[restaurant], food[Chinese], priceRange[high], customer rating[1 out of 5], area[riverside], familyFriendly[yes], near[All Bar One]"	On the riverside near All Bar One is a Chinese restaurant called The Cricketers. It is children friendly and has a customer rating of 1 out of 5.
"name[The Cricketers], eatType[restaurant], food[Chinese], priceRange[high], customer rating[average], area[city centre], familyFriendly[no], near[All Bar One]"	A restaurant named The Cricketers is a high priced Chinese restaurant located in the city centre near All Bar One. It has an average customer rating and is not children friendly.
"name[The Cricketers], eatType[restaurant], food[Chinese], priceRange[high], customer rating[average], area[city centre], familyFriendly[yes], near[All Bar One]"	A children friendly restaurant named The Cricketers is located near All Bar One in the city centre. It has an average customer rating and a high price range.
"name[The Cricketers], eatType[restaurant], food[Chinese], priceRange[high], customer rating[average], area[riverside], familyFriendly[no], near[All Bar One]"	High priced Chinese restaurant The Cricketers is located in the riverside area near the All Bar One. It has an average customer rating and is not children friendly.
"name[The Cricketers], eatType[restaurant], food[Chinese], priceRange[high], customer rating[average], area[riverside], familyFriendly[yes], near[All Bar One]"	The The Cricketers restaurant is a high priced restaurant located in the riverside area near the All Bar One. It has an average customer rating and is children friendly.
"name[The Cricketers], eatType[restaurant], food[Chinese], priceRange[less than Â£20], customer rating[low], area[city centre], familyFriendly[no], near[All Bar One]"	A Chinese restaurant near All Bar One in the city centre is The Cricketers. It is not family-friendly and is in the less than £20 price range.
"name[The Cricketers], eatType[restaurant], food[Chinese], priceRange[less than Â£20], customer rating[low], area[city centre], familyFriendly[yes], near[All Bar One]"	This restaurant is located in the city centre near the All Bar One.  It is called The Cricketers and is family-friendly.  It serves Chinese food for less than £20.
"name[The Cricketers], eatType[restaurant], food[Chinese], priceRange[less than Â£20], customer rating[low], area[riverside], familyFriendly[no], near[All Bar One]"	At the riverside near All Bar One is a Chinese restaurant called The Cricketers. It is not family-friendly and has a price range of less than £20.
"name[The Cricketers], eatType[restaurant], food[Chinese], priceRange[less than Â£20], customer rating[low], area[riverside], familyFriendly[yes], near[All Bar One]"	Family friendly restaurant The Cricketers is located near All Bar One in the riverside area. It has a low customer rating and a price range of less than £20.
"name[The Cricketers], eatType[restaurant], food[Chinese], priceRange[moderate], customer rating[1 out of 5], area[city centre], familyFriendly[no], near[All Bar One]"	An Chinese restaurant named The Cricketers is located near All Bar One in the city centre. It is not kid friendly and is moderately priced.
"name[The Cricketers], eatType[restaurant], food[Chinese], priceRange[moderate], customer rating[1 out of 5], area[city centre], familyFriendly[yes], near[All Bar One]"	For a moderate priced Chinese restaurant that is kid friendly in the city centre near All Bar One then go to The Cricketers
"name[The Cricketers], eatType[restaurant], food[Chinese], priceRange[moderate], customer rating[1 out of 5], area[riverside], familyFriendly[no], near[All Bar One]"	An Chinese restaurant named The Cricketers is located near All Bar One in the riverside area. It is not kid friendly and has a moderate price range.
"name[The Cricketers], eatType[restaurant], food[Chinese], priceRange[moderate], customer rating[1 out of 5], area[riverside], familyFriendly[yes], near[All Bar One]"	Come to The Cricketers restaurant for families with children and a low customer rating. It is located in riverside near All Bar One and has a moderate price range.
"name[The Cricketers], eatType[restaurant], food[Chinese], priceRange[moderate], customer rating[3 out of 5], area[city centre], familyFriendly[no], near[All Bar One]"	An Chinese restaurant near All Bar One in the city centre is The Cricketers. It is not kid friendly and is moderately priced.
"name[The Cricketers], eatType[restaurant], food[Chinese], priceRange[moderate], customer rating[3 out of 5], area[city centre], familyFriendly[yes], near[All Bar One]"	Chinese restaurant The Cricketers is located in the city centre near All Bar One. It is a kid friendly restaurant with a moderate price range.
"name[The Cricketers], eatType[restaurant], food[Chinese], priceRange[moderate], customer rating[3 out of 5], area[riverside], familyFriendly[no], near[All Bar One]"	An Chinese restaurant named The Cricketers is located near All Bar One in the riverside area. It is not kid friendly and has a moderate price range.
"name[The Cricketers], eatType[restaurant], food[Chinese], priceRange[moderate], customer rating[3 out of 5], area[riverside], familyFriendly[yes], near[All Bar One]"	Riverside restaurant The Cricketers is a kid friendly restaurant with a moderate price range and a customer rating of 3 out of 5.  It is located near All Bar One.
"name[The Cricketers], eatType[restaurant], food[Chinese], priceRange[more than Â£30], customer rating[high], area[city centre], familyFriendly[no], near[All Bar One]"	A high rated Chinese restaurant in the city centre near All Bar One is The Cricketers. It is not children friendly and has a price range of more than £30.
"name[The Cricketers], eatType[restaurant], food[Chinese], priceRange[more than Â£30], customer rating[high], area[city centre], familyFriendly[yes], near[All Bar One]"	A high rated Chinese restaurant in the city centre near All Bar One is The Cricketers. It is children friendly and has a price range of more than £30.
"name[The Cricketers], eatType[restaurant], food[Chinese], priceRange[more than Â£30], customer rating[high], area[riverside], familyFriendly[no], near[All Bar One]"	Riverside has a high rated restaurant called The Cricketers. It is not children friendly and is in the price range of more than £30. It is near All Bar One.
"name[The Cricketers], eatType[restaurant], food[Chinese], priceRange[more than Â£30], customer rating[high], area[riverside], familyFriendly[yes], near[All Bar One]"	This children friendly restaurant named The Cricketers is located near All Bar One in the riverside area. It serves Chinese food and has a price range of more than £30.
"name[The Cricketers], eatType[restaurant], food[English], priceRange[Â£20-25], customer rating[high], area[city centre], familyFriendly[no], near[All Bar One]"	A high rated English restaurant in the city centre near All Bar One is The Cricketers. It is not kid friendly and has a price range of £20-25.
"name[The Cricketers], eatType[restaurant], food[English], priceRange[Â£20-25], customer rating[high], area[city centre], familyFriendly[yes], near[All Bar One]"	A high rated English restaurant in the city centre near All Bar One is The Cricketers. It is kids friendly and has a price range of £20-25.
"name[The Cricketers], eatType[restaurant], food[English], priceRange[Â£20-25], customer rating[high], area[riverside], familyFriendly[no], near[All Bar One]"	There is a high rated English restaurant near All Bar One called The Cricketers which is not kid friendly and has a price range of £20-25.
"name[The Cricketers], eatType[restaurant], food[English], priceRange[Â£20-25], customer rating[high], area[riverside], familyFriendly[yes], near[All Bar One]"	High rated English restaurant The Cricketers is located in the riverside area near All Bar One. It is kid friendly.
"name[The Cricketers], eatType[restaurant], food[English], priceRange[cheap], customer rating[5 out of 5], area[city centre], familyFriendly[no], near[CafÃ© Rouge]"	The The Cricketers restaurant is a cheap English restaurant located in the city centre near Café Rouge.  It has a customer rating of 5 out of 5 and is not family-friendly.
"name[The Cricketers], eatType[restaurant], food[English], priceRange[cheap], customer rating[5 out of 5], area[city centre], familyFriendly[yes], near[CafÃ© Rouge]"	"For a cheap English restaurant in the city centre near Café Rouge, try The Cricketers. It is family friendly."
"name[The Cricketers], eatType[restaurant], food[English], priceRange[cheap], customer rating[5 out of 5], area[riverside], familyFriendly[no], near[CafÃ© Rouge]"	Riverside restaurant The Cricketers is a cheap English restaurant with a customer rating of 5 out of 5. It is not family friendly.
"name[The Cricketers], eatType[restaurant], food[English], priceRange[cheap], customer rating[5 out of 5], area[riverside], familyFriendly[yes], near[CafÃ© Rouge]"	This restaurant is located in the riverside area near the Café Rouge.  It is called The Cricketers and is family friendly.  It serves English food and has a cheap price range.
"name[The Cricketers], eatType[restaurant], food[English], priceRange[cheap], customer rating[average], area[city centre], familyFriendly[no], near[CafÃ© Rouge]"	The The Cricketers restaurant is a cheap English restaurant located in the city centre near the Café Rouge. It has an average customer rating and is not family-friendly.
"name[The Cricketers], eatType[restaurant], food[English], priceRange[cheap], customer rating[average], area[city centre], familyFriendly[yes], near[CafÃ© Rouge]"	"For a cheap English restaurant in the city centre near Café Rouge, The Cricketers is a great place to eat. It is family friendly."
"name[The Cricketers], eatType[restaurant], food[English], priceRange[cheap], customer rating[average], area[riverside], familyFriendly[no], near[CafÃ© Rouge]"	The The Cricketers restaurant is a cheap fast food restaurant located in riverside near Café Rouge.  It has an average customer rating and is not family friendly.
"name[The Cricketers], eatType[restaurant], food[English], priceRange[cheap], customer rating[average], area[riverside], familyFriendly[yes], near[CafÃ© Rouge]"	Cheap family friendly restaurant The Cricketers is located in the riverside area near Café Rouge. It has an average customer rating.
"name[The Cricketers], eatType[restaurant], food[English], priceRange[high], customer rating[1 out of 5], area[city centre], familyFriendly[no], near[CafÃ© Rouge]"	English restaurant The Cricketers is located in the city centre near Café Rouge. It is not children friendly and is in the high price range.
"name[The Cricketers], eatType[restaurant], food[English], priceRange[high], customer rating[1 out of 5], area[city centre], familyFriendly[yes], near[CafÃ© Rouge]"	There is a high priced English restaurant called The Cricketers located in the city centre near Café Rouge with a customer rating of 1 out of 5.
"name[The Cricketers], eatType[restaurant], food[English], priceRange[high], customer rating[1 out of 5], area[riverside], familyFriendly[no], near[CafÃ© Rouge]"	High priced English restaurant The Cricketers is located in the riverside area near Café Rouge. It is not child friendly.
"name[The Cricketers], eatType[restaurant], food[English], priceRange[high], customer rating[1 out of 5], area[riverside], familyFriendly[yes], near[CafÃ© Rouge]"	On the riverside near Café Rouge is a English restaurant called The Cricketers. It is children friendly and has a customer rating of 1 out of 5.
"name[The Cricketers], eatType[restaurant], food[English], priceRange[high], customer rating[average], area[city centre], familyFriendly[no], near[CafÃ© Rouge]"	A restaurant named The Cricketers is a high priced English restaurant located in the city centre near Café Rouge. It has an average customer rating and is not children friendly.
"name[The Cricketers], eatType[restaurant], food[English], priceRange[high], customer rating[average], area[city centre], familyFriendly[yes], near[CafÃ© Rouge]"	A children friendly restaurant named The Cricketers is located near Café Rouge in the city centre. It has an average customer rating and a high price range.
"name[The Cricketers], eatType[restaurant], food[English], priceRange[high], customer rating[average], area[riverside], familyFriendly[no], near[CafÃ© Rouge]"	High priced English restaurant The Cricketers is located in the riverside area near the Café Rouge. It has an average customer rating and is not children friendly.
"name[The Mill], eatType[pub], food[English], priceRange[high], area[riverside], familyFriendly[yes], near[Raja Indian Cuisine]"	Raja Indian Cuisine is a pub called The Mill that serves English food and is children friendly. It is in the high price range and is located in the riverside area.
"name[The Mill], eatType[pub], food[English], priceRange[less than Â£20], area[city centre], familyFriendly[no], near[Raja Indian Cuisine]"	The Mill is a pub that serves English food for less than £20. It is located in the city centre near Raja Indian Cuisine and is not family friendly.
"name[The Mill], eatType[pub], food[English], priceRange[less than Â£20], area[city centre], familyFriendly[yes], near[Raja Indian Cuisine]"	Family friendly The Mill is a pub that serves English food for less than £20. It is located in the city centre near Raja Indian Cuisine.
"name[The Mill], eatType[pub], food[English], priceRange[less than Â£20], area[riverside], familyFriendly[no], near[Raja Indian Cuisine]"	In the riverside area near Raja Indian Cuisine is a pub called The Mill. It serves English food for less than £20. It is not family-friendly.
"name[The Mill], eatType[pub], food[English], priceRange[less than Â£20], area[riverside], familyFriendly[yes], near[Raja Indian Cuisine]"	At the riverside near Raja Indian Cuisine is a pub called The Mill. It serves English food for less than £20 and is family friendly.
"name[The Mill], eatType[pub], food[English], priceRange[moderate], area[city centre], familyFriendly[no], near[Raja Indian Cuisine]"	The Mills is a pub that serves English food in the moderate price range in the city centre near Raja Indian Cuisine and is not kid friendly.
"name[The Mill], eatType[pub], food[English], priceRange[moderate], area[city centre], familyFriendly[yes], near[Raja Indian Cuisine]"	Near Raja Indian Cuisine is a pub called The Mill. It serves English food and is kid friendly. It is in the city centre and has a moderate price range.
"name[The Mill], eatType[pub], food[English], priceRange[moderate], area[riverside], familyFriendly[no], near[Raja Indian Cuisine]"	The The Mill is a pub that serves English food at a moderate price range. It is not kid friendly and is located near Raja Indian Cuisine in the riverside area.
"name[The Mill], eatType[pub], food[English], priceRange[moderate], area[riverside], familyFriendly[yes], near[Raja Indian Cuisine]"	On the riverside near Raja Indian Cuisine is a kid friendly pub called The Mill. It serves English food and has a moderate price range.
"name[The Mill], eatType[pub], food[English], priceRange[more than Â£30], area[riverside], familyFriendly[yes], near[Raja Indian Cuisine]"	By the riverside near Raja Indian Cuisine is a child friendly pub called The Mill. It serves English food and has a price range of more than £30.
"name[The Mill], eatType[pub], food[Fast food], priceRange[Â£20-25], area[riverside], familyFriendly[yes], near[Raja Indian Cuisine]"	On the riverside near Raja Indian Cuisine is a kid friendly pub called The Mill. It serves Fast food food and has a price range of £20-25.
"name[The Mill], eatType[pub], food[Fast food], priceRange[Â£20-25], customer rating[high], area[city centre], familyFriendly[no], near[CafÃ© Rouge]"	The The Mill is a pub serving Fast food food in the £20-25 price range with a high customer rating located in the city centre near Café Rouge.  It is not kid friendly.
"name[The Mill], eatType[pub], food[Fast food], priceRange[Â£20-25], customer rating[high], area[city centre], familyFriendly[yes], near[CafÃ© Rouge]"	Café Rouge is a pub named The Mill that serves Fast food food in the £20-25 price range with a high customer rating in the city centre and is kid friendly.
"name[The Mill], eatType[pub], food[Fast food], priceRange[Â£20-25], customer rating[high], area[riverside], familyFriendly[no], near[CafÃ© Rouge]"	The Mill is a pub that serves Fast food food in the riverside area. It is not kid friendly and has a high customer rating.  It is near Café Rouge and has a price range of £20-25.
"name[The Mill], eatType[pub], food[Fast food], priceRange[Â£20-25], customer rating[high], area[riverside], familyFriendly[yes], near[CafÃ© Rouge]"	At the riverside near Café Rouge there is a pub called The Mill that serves Fast food food and has a high customer rating. It is kids friendly and has a price range of £20-25.
"name[The Mill], eatType[pub], food[Fast food], priceRange[Â£20-25], customer rating[high], area[riverside], familyFriendly[yes], near[CafÃ© Sicilia]"	At the riverside near Café Sicilia there is a pub called The Mill that serves Fast food food and has a high customer rating. It is kids friendly and has a price range of £20-25.
"name[The Mill], eatType[pub], food[Fast food], priceRange[cheap], area[riverside], familyFriendly[yes], near[Raja Indian Cuisine]"	"Situated on the riverside near Raja Indian Cuisine, The Mill is a family friendly pub that serves Fast food food at a cheap price."
"name[The Mill], eatType[pub], food[Fast food], priceRange[cheap], customer rating[5 out of 5], area[city centre], familyFriendly[no], near[CafÃ© Sicilia]"	Fast food food is served at The Mill pub which is not family-friendly.  It is located in the city centre near Café Sicilia.  It is cheap and has a customer rating of 5 out of 5.
"name[The Mill], eatType[pub], food[Fast food], priceRange[cheap], customer rating[5 out of 5], area[city centre], familyFriendly[yes], near[CafÃ© Sicilia]"	There is a cheap pub that serves Fast food food called The Mill in the city centre near Café Sicilia. It is family-friendly and has a customer rating of 5 out of 5.
"name[The Mill], eatType[pub], food[Fast food], priceRange[cheap], customer rating[5 out of 5], area[riverside], familyFriendly[no], near[CafÃ© Sicilia]"	This pub in the riverside area near Café Sicilia is called The Mill.  It serves Fast food food and has a customer rating of 5 out of 5.  It is cheap and not family-friendly.
"name[The Mill], eatType[pub], food[Fast food], priceRange[cheap], customer rating[5 out of 5], area[riverside], familyFriendly[yes], near[CafÃ© Sicilia]"	On the riverside near Café Sicilia is a pub called The Mill. It serves Fast food food and is family friendly. It has a cheap price range and a customer rating of 5 out of 5.
"name[The Mill], eatType[pub], food[Fast food], priceRange[cheap], customer rating[average], area[city centre], familyFriendly[no], near[CafÃ© Sicilia]"	An average rated pub serving Fast food food is The Mill.  It is not family-friendly and is located in the city centre near Café Sicilia.  The price range is cheap.
"name[The Mill], eatType[pub], food[Fast food], priceRange[cheap], customer rating[average], area[city centre], familyFriendly[yes], near[CafÃ© Sicilia]"	An average rated pub near Café Sicilia in the city centre is The Mill. It is family-friendly and serves cheap Fast food food.
"name[The Mill], eatType[pub], food[Fast food], priceRange[cheap], customer rating[average], area[riverside], familyFriendly[no], near[CafÃ© Sicilia]"	An average rated pub serving Fast food food is The Mill.  It is not family-friendly and is located in the riverside area near Café Sicilia.  The price range is cheap.
"name[The Mill], eatType[pub], food[Fast food], priceRange[cheap], customer rating[average], area[riverside], familyFriendly[yes], near[CafÃ© Sicilia]"	"Situated on the riverside near Café Sicilia, The Mill is a family friendly pub that serves Fast food food. It has an average customer rating."
"name[The Mill], eatType[pub], food[Fast food], priceRange[high], customer rating[1 out of 5], area[city centre], familyFriendly[no], near[CafÃ© Sicilia]"	The The Mill is a pub that serves Fast food food at a high price range. It is located in the city centre near Café Sicilia and is not child friendly. It has a customer rating of 1 out of 5.
"name[The Mill], eatType[pub], food[Fast food], priceRange[high], customer rating[1 out of 5], area[city centre], familyFriendly[yes], near[CafÃ© Sicilia]"	The The Mill is a children friendly pub serving Fast food food in the high price range with a customer rating of 1 out of 5. It is located in the city centre near Café Sicilia.
"name[The Mill], eatType[pub], food[Fast food], priceRange[high], customer rating[1 out of 5], area[riverside], familyFriendly[no], near[CafÃ© Sicilia]"	Located near Café Sicilia in the riverside area is a pub called The Mill. It serves Fast food food and is not child friendly. It has a high price range and a customer rating of 1 out of 5.
"name[The Mill], eatType[pub], food[Fast food], priceRange[high], customer rating[1 out of 5], area[riverside], familyFriendly[yes], near[CafÃ© Sicilia]"	Come to The Mill pub near Café Sicilia on the riverside.  It serves Fast food food and is children friendly.  It has a high price range and a customer rating of 1 out of 5.
"name[The Mill], eatType[pub], food[Fast food], priceRange[high], customer rating[average], area[city centre], familyFriendly[no], near[CafÃ© Sicilia]"	Fast food food is served at The Mill pub with a high price range and an average customer rating. It is located in the city centre near Café Sicilia and is not children friendly.
"name[The Mill], eatType[pub], food[Fast food], priceRange[high], customer rating[average], area[city centre], familyFriendly[yes], near[CafÃ© Sicilia]"	This pub named The Mill is located in the city centre near Café Sicilia. It is children friendly and serves Fast food food at a high price range. It has an average customer rating.
"name[The Mill], eatType[pub], food[Fast food], priceRange[high], customer rating[average], area[riverside], familyFriendly[no], near[CafÃ© Sicilia]"	At the riverside near Café Sicilia is a pub called The Mill. It serves Fast food food and has a high price range. It has an average customer rating and is not children friendly.
"name[The Mill], eatType[pub], food[Fast food], priceRange[high], customer rating[average], area[riverside], familyFriendly[yes], near[CafÃ© Sicilia]"	High priced Fast food pub The Mill is located in the riverside area near Café Sicilia. It has an average customer rating and is children friendly.
"name[The Mill], eatType[pub], food[Fast food], priceRange[less than Â£20], customer rating[low], area[city centre], familyFriendly[no], near[CafÃ© Sicilia]"	The Mill is a pub that serves Fast food food for less than £20. It is located in the city centre near Café Sicilia. It is not family-friendly and has a low customer rating.
"name[The Mill], eatType[pub], food[Fast food], priceRange[less than Â£20], customer rating[low], area[city centre], familyFriendly[yes], near[CafÃ© Sicilia]"	Family friendly Fast food pub The Mill has a low customer rating and a price range of less than £20. It is located in the city centre near Café Sicilia.
"name[The Mill], eatType[pub], food[Fast food], priceRange[less than Â£20], customer rating[low], area[riverside], familyFriendly[no], near[CafÃ© Sicilia]"	On the riverside near Café Sicilia is The Mill pub.  It is not family-friendly and has a low customer rating.  It serves Fast food food for less than £20.
"name[The Mill], eatType[pub], food[Fast food], priceRange[less than Â£20], customer rating[low], area[riverside], familyFriendly[yes], near[CafÃ© Sicilia]"	"Although it has a low customer rating, The Mill is a family friendly pub serving Fast food food for less than £20. It is located in the riverside area near Café Sicilia."
"name[The Mill], eatType[pub], food[Fast food], priceRange[moderate], customer rating[1 out of 5], area[city centre], familyFriendly[no], near[CafÃ© Sicilia]"	"Rated 1 out of 5, The Mill is a pub serving Fast food food in the moderate price range in the city centre near Café Sicilia. It is not kid friendly."
"name[The Mill], eatType[pub], food[Fast food], priceRange[moderate], customer rating[1 out of 5], area[city centre], familyFriendly[yes], near[CafÃ© Sicilia]"	A pub named The Mill is located in the city centre near Café Sicilia. It is kid friendly and serves Fast food food at a moderate price range. It has a customer rating of 1 out of 5.
"name[The Mill], eatType[pub], food[Fast food], priceRange[moderate], customer rating[1 out of 5], area[riverside], familyFriendly[no], near[CafÃ© Sicilia]"	"Rated 1 out of 5, The Mill is a pub that serves Fast food food at a moderate price. It is located in the riverside area near Café Sicilia and is not kid friendly."
"name[The Mill], eatType[pub], food[Fast food], priceRange[moderate], customer rating[1 out of 5], area[riverside], familyFriendly[yes], near[CafÃ© Sicilia]"	The The Mill is a pub that serves Fast food food and is kids friendly. It is located near Café Sicilia in the riverside area. It has a moderate price range and a customer rating of 1 out of 5.
"name[The Mill], eatType[pub], food[Fast food], priceRange[moderate], customer rating[3 out of 5], area[city centre], familyFriendly[no], near[CafÃ© Sicilia]"	"Serving Fast food food, The Mill is a pub with a moderate price range in the city centre near Café Sicilia. It is not kid friendly and has a customer rating of 3 out of 5."
"name[The Mill], eatType[pub], food[Fast food], priceRange[moderate], customer rating[3 out of 5], area[city centre], familyFriendly[yes], near[CafÃ© Sicilia]"	There is a moderately priced Fast food pub near Café Sicilia in the city centre called The Mill. It is kid friendly and has a customer rating of 3 out of 5.
"name[The Mill], eatType[pub], food[Fast food], priceRange[moderate], customer rating[3 out of 5], area[riverside], familyFriendly[no], near[CafÃ© Sicilia]"	A pub named The Mill is located near Café Sicilia in the riverside area. It serves Fast food food and has a moderate price range. It is not kid friendly and has a customer rating of 3 out of 5.
"name[The Mill], eatType[pub], food[Fast food], priceRange[moderate], customer rating[3 out of 5], area[riverside], familyFriendly[yes], near[CafÃ© Sicilia]"	At the riverside near Café Sicilia is a pub called The Mill. It serves Fast food food and has a moderate price range. It is kid friendly and has a customer rating of 3 out of 5.
"name[The Mill], eatType[restaurant], food[English], priceRange[high], area[riverside], familyFriendly[yes], near[Raja Indian Cuisine]"	"For a high priced English restaurant in the riverside area, try The Mill. It is children friendly and is located near Raja Indian Cuisine."
"name[The Mill], eatType[restaurant], food[English], priceRange[high], customer rating[average], area[riverside], familyFriendly[yes], near[CafÃ© Rouge]"	The The Mill restaurant is a high priced restaurant located in the riverside area near the Café Rouge. It has an average customer rating and is children friendly.
"name[The Mill], eatType[restaurant], food[English], priceRange[less than Â£20], area[city centre], familyFriendly[no], near[Raja Indian Cuisine]"	An English restaurant named The Mill is located near Raja Indian Cuisine in the city centre. It is not family-friendly and has a price range of less than £20.
"name[The Mill], eatType[restaurant], food[English], priceRange[less than Â£20], area[city centre], familyFriendly[yes], near[Raja Indian Cuisine]"	English restaurant The Mill is located in the city centre near Raja Indian Cuisine. It is family-friendly and is in the less than £20 price range.
"name[The Mill], eatType[restaurant], food[English], priceRange[less than Â£20], area[riverside], familyFriendly[no], near[Raja Indian Cuisine]"	At the riverside near Raja Indian Cuisine is a English restaurant called The Mill. It is not family-friendly and has a price range of less than £20.
"name[The Mill], eatType[restaurant], food[English], priceRange[less than Â£20], area[riverside], familyFriendly[yes], near[Raja Indian Cuisine]"	The The Mill is a family friendly restaurant that serves English food for less than £20. It is located in the riverside area near Raja Indian Cuisine.
"name[The Mill], eatType[restaurant], food[English], priceRange[less than Â£20], customer rating[low], area[city centre], familyFriendly[no], near[CafÃ© Rouge]"	A English restaurant near Café Rouge in the city centre is The Mill. It is not family-friendly and is in the less than £20 price range.
"name[The Mill], eatType[restaurant], food[English], priceRange[less than Â£20], customer rating[low], area[city centre], familyFriendly[yes], near[CafÃ© Rouge]"	This restaurant is located in the city centre near the Café Rouge.  It is called The Mill and is family-friendly.  It serves English food for less than £20.
"name[The Mill], eatType[restaurant], food[English], priceRange[less than Â£20], customer rating[low], area[riverside], familyFriendly[no], near[CafÃ© Rouge]"	At the riverside near Café Rouge is a English restaurant called The Mill. It is not family-friendly and has a price range of less than £20.
"name[The Mill], eatType[restaurant], food[English], priceRange[less than Â£20], customer rating[low], area[riverside], familyFriendly[yes], near[CafÃ© Rouge]"	Family friendly restaurant The Mill is located near Café Rouge in the riverside area. It has a low customer rating and a price range of less than £20.
"name[The Mill], eatType[restaurant], food[English], priceRange[moderate], area[city centre], familyFriendly[no], near[Raja Indian Cuisine]"	An English restaurant near Raja Indian Cuisine in the city centre is The Mill. It is not kid friendly and is moderately priced.
"name[The Mill], eatType[restaurant], food[English], priceRange[moderate], area[city centre], familyFriendly[yes], near[Raja Indian Cuisine]"	English restaurant The Mill is located in the city centre near Raja Indian Cuisine. It is a kid friendly restaurant with a moderate price range.
"name[The Mill], eatType[restaurant], food[English], priceRange[moderate], area[riverside], familyFriendly[no], near[Raja Indian Cuisine]"	There is a moderately priced English restaurant called The Mill located in riverside near Raja Indian Cuisine. It is not kids friendly.
"name[The Mill], eatType[restaurant], food[English], priceRange[moderate], area[riverside], familyFriendly[yes], near[Raja Indian Cuisine]"	Riverside restaurant The Mill is a kid friendly restaurant that serves English food at a moderate price range. It is located near Raja Indian Cuisine.
"name[The Mill], eatType[restaurant], food[English], priceRange[moderate], customer rating[1 out of 5], area[city centre], familyFriendly[no], near[CafÃ© Rouge]"	An English restaurant named The Mill is located near Café Rouge in the city centre. It is not kid friendly and is moderately priced.
"name[The Mill], eatType[restaurant], food[English], priceRange[moderate], customer rating[1 out of 5], area[city centre], familyFriendly[yes], near[CafÃ© Rouge]"	For a moderate priced English restaurant that is kid friendly in the city centre near Café Rouge then go to The Mill
"name[The Mill], eatType[restaurant], food[English], priceRange[moderate], customer rating[1 out of 5], area[riverside], familyFriendly[no], near[CafÃ© Rouge]"	An English restaurant named The Mill is located near Café Rouge in the riverside area. It is not kid friendly and has a moderate price range.
"name[The Mill], eatType[restaurant], food[English], priceRange[moderate], customer rating[1 out of 5], area[riverside], familyFriendly[yes], near[CafÃ© Rouge]"	Come to The Mill restaurant for families with children and a low customer rating. It is located in riverside near Café Rouge and has a moderate price range.
"name[The Mill], eatType[restaurant], food[English], priceRange[moderate], customer rating[3 out of 5], area[city centre], familyFriendly[no], near[CafÃ© Rouge]"	An English restaurant near Café Rouge in the city centre is The Mill. It is not kid friendly and is moderately priced.
"name[The Mill], eatType[restaurant], food[English], priceRange[moderate], customer rating[3 out of 5], area[city centre], familyFriendly[yes], near[CafÃ© Rouge]"	English restaurant The Mill is located in the city centre near Café Rouge. It is a kid friendly restaurant with a moderate price range.
"name[The Mill], eatType[restaurant], food[English], priceRange[moderate], customer rating[3 out of 5], area[riverside], familyFriendly[no], near[CafÃ© Rouge]"	An English restaurant named The Mill is located near Café Rouge in the riverside area. It is not kid friendly and has a moderate price range.
"name[The Mill], eatType[restaurant], food[English], priceRange[moderate], customer rating[3 out of 5], area[riverside], familyFriendly[yes], near[CafÃ© Rouge]"	Riverside restaurant The Mill is a kid friendly restaurant with a moderate price range and a customer rating of 3 out of 5.  It is located near Café Rouge.
"name[The Mill], eatType[restaurant], food[English], priceRange[more than Â£30], area[riverside], familyFriendly[yes], near[Raja Indian Cuisine]"	"For a child friendly restaurant that serves English food and has a price range of more than £30, then The Mill is located near Raja Indian Cuisine in the riverside area."
"name[The Mill], eatType[restaurant], food[English], priceRange[more than Â£30], customer rating[high], area[city centre], familyFriendly[no], near[CafÃ© Rouge]"	A high rated English restaurant in the city centre near Café Rouge is The Mill. It is not children friendly and has a price range of more than £30.
"name[The Mill], eatType[restaurant], food[English], priceRange[more than Â£30], customer rating[high], area[city centre], familyFriendly[yes], near[CafÃ© Rouge]"	A high rated English restaurant in the city centre near Café Rouge is The Mill. It is children friendly and has a price range of more than £30.
"name[The Mill], eatType[restaurant], food[English], priceRange[more than Â£30], customer rating[high], area[riverside], familyFriendly[no], near[CafÃ© Rouge]"	Riverside has a high rated restaurant called The Mill. It is not children friendly and is in the price range of more than £30. It is near Café Rouge.
"name[The Mill], eatType[restaurant], food[English], priceRange[more than Â£30], customer rating[high], area[riverside], familyFriendly[yes], near[CafÃ© Rouge]"	This children friendly restaurant named The Mill is located near Café Rouge in the riverside area. It serves English food and has a price range of more than £30.
"name[The Mill], eatType[restaurant], food[Fast food], priceRange[Â£20-25], area[riverside], familyFriendly[yes], near[Raja Indian Cuisine]"	Kid friendly Fast food restaurant The Mill is located near Raja Indian Cuisine in the riverside area. The price range is £20-25.
"name[The Mill], eatType[restaurant], food[Fast food], priceRange[cheap], area[riverside], familyFriendly[yes], near[Raja Indian Cuisine]"	On the riverside near Raja Indian Cuisine is a family friendly restaurant called The Mill. It serves cheap Fast food food.
"name[The Phoenix], eatType[pub], food[Fast food], priceRange[cheap], area[riverside], familyFriendly[yes], near[Raja Indian Cuisine]"	"Situated on the riverside near Raja Indian Cuisine, The Phoenix is a family friendly pub that serves Fast food food at a cheap price."
"name[The Phoenix], eatType[pub], food[Fast food], priceRange[high], area[city centre], familyFriendly[no], near[Raja Indian Cuisine]"	"Serving Fast food food at a high price range, The Phoenix is a pub located in the city centre near Raja Indian Cuisine. It is not child friendly."
"name[The Phoenix], eatType[pub], food[Fast food], priceRange[high], area[city centre], familyFriendly[yes], near[Raja Indian Cuisine]"	Fast food food is served at The Phoenix pub which is children friendly and is located in the city centre near Raja Indian Cuisine. It has a high price range.
"name[The Phoenix], eatType[pub], food[Fast food], priceRange[high], area[riverside], familyFriendly[no], near[Raja Indian Cuisine]"	"Situated near Raja Indian Cuisine in the riverside area, The Phoenix is a pub that serves Fast food food at a high price range. It is not child friendly."
"name[The Phoenix], eatType[pub], food[Fast food], priceRange[high], area[riverside], familyFriendly[yes], near[Raja Indian Cuisine]"	Raja Indian Cuisine is a pub called The Phoenix that serves Fast food food and is children friendly. It is in the high price range and is located in the riverside area.
"name[The Phoenix], eatType[pub], food[Fast food], priceRange[less than Â£20], area[city centre], familyFriendly[no], near[Raja Indian Cuisine]"	The Phoenix is a pub that serves Fast food food for less than £20. It is located in the city centre near Raja Indian Cuisine and is not family friendly.
"name[The Phoenix], eatType[pub], food[Fast food], priceRange[less than Â£20], area[city centre], familyFriendly[yes], near[Raja Indian Cuisine]"	Family friendly The Phoenix is a pub that serves Fast food food for less than £20. It is located in the city centre near Raja Indian Cuisine.
"name[The Phoenix], eatType[pub], food[Fast food], priceRange[less than Â£20], area[riverside], familyFriendly[no], near[Raja Indian Cuisine]"	In the riverside area near Raja Indian Cuisine is a pub called The Phoenix. It serves Fast food food for less than £20. It is not family-friendly.
"name[The Phoenix], eatType[pub], food[Fast food], priceRange[less than Â£20], area[riverside], familyFriendly[yes], near[Raja Indian Cuisine]"	At the riverside near Raja Indian Cuisine is a pub called The Phoenix. It serves Fast food food for less than £20 and is family friendly.
"name[The Phoenix], eatType[pub], food[Fast food], priceRange[moderate], area[city centre], familyFriendly[no], near[Raja Indian Cuisine]"	The Phoenixs is a pub that serves Fast food food in the moderate price range in the city centre near Raja Indian Cuisine and is not kid friendly.
"name[The Phoenix], eatType[pub], food[Fast food], priceRange[moderate], area[city centre], familyFriendly[yes], near[Raja Indian Cuisine]"	Near Raja Indian Cuisine is a pub called The Phoenix. It serves Fast food food and is kid friendly. It is in the city centre and has a moderate price range.
"name[The Phoenix], eatType[pub], food[Fast food], priceRange[moderate], area[riverside], familyFriendly[no], near[Raja Indian Cuisine]"	The The Phoenix is a pub that serves Fast food food at a moderate price range. It is not kid friendly and is located near Raja Indian Cuisine in the riverside area.
"name[The Phoenix], eatType[pub], food[Fast food], priceRange[moderate], area[riverside], familyFriendly[yes], near[Raja Indian Cuisine]"	On the riverside near Raja Indian Cuisine is a kid friendly pub called The Phoenix. It serves Fast food food and has a moderate price range.
"name[The Phoenix], eatType[pub], food[Fast food], priceRange[moderate], customer rating[3 out of 5], area[riverside], familyFriendly[yes], near[CafÃ© Sicilia]"	At the riverside near Café Sicilia is a pub called The Phoenix. It serves Fast food food and has a moderate price range. It is kid friendly and has a customer rating of 3 out of 5.
"name[The Phoenix], eatType[pub], food[Fast food], priceRange[more than Â£30], area[riverside], familyFriendly[yes], near[Raja Indian Cuisine]"	By the riverside near Raja Indian Cuisine is a child friendly pub called The Phoenix. It serves Fast food food and has a price range of more than £30.
"name[The Phoenix], eatType[pub], food[Fast food], priceRange[more than Â£30], customer rating[high], area[city centre], familyFriendly[no], near[CafÃ© Sicilia]"	"Located in the city centre near Café Sicilia, The Phoenix is a pub that serves Fast food food with a price range of more than £30. It has a high customer rating and is not child friendly."
"name[The Phoenix], eatType[pub], food[Fast food], priceRange[more than Â£30], customer rating[high], area[city centre], familyFriendly[yes], near[CafÃ© Sicilia]"	The Phoenix is a children friendly pub serving Fast food food in the city centre near Café Sicilia. It has a high customer rating and a price range of more than £30.
"name[The Phoenix], eatType[pub], food[Fast food], priceRange[more than Â£30], customer rating[high], area[riverside], familyFriendly[no], near[CafÃ© Sicilia]"	In the riverside area near Café Sicilia is a pub called The Phoenix. It serves Fast food food and has a high customer rating. It is not children friendly and the price range is more than £30.
"name[The Phoenix], eatType[pub], food[Fast food], priceRange[more than Â£30], customer rating[high], area[riverside], familyFriendly[yes], near[CafÃ© Sicilia]"	In the riverside area near Café Sicilia is a pub called The Phoenix. It is children friendly and has a high customer rating. The price range is more than £30.
"name[The Phoenix], eatType[pub], food[French], priceRange[Â£20-25], area[riverside], familyFriendly[yes], near[Raja Indian Cuisine]"	On the riverside near Raja Indian Cuisine is a kid friendly pub called The Phoenix. It serves French food and has a price range of £20-25.
"name[The Phoenix], eatType[pub], food[French], priceRange[Â£20-25], customer rating[3 out of 5], area[city centre], familyFriendly[no], near[CafÃ© Sicilia]"	The Phoenix is a pub serving French food in the £20-25 price range. It is located in the city centre near Café Sicilia and is not kid friendly. It has a customer rating of 3 out of 5.
"name[The Phoenix], eatType[pub], food[French], priceRange[Â£20-25], customer rating[3 out of 5], area[city centre], familyFriendly[yes], near[CafÃ© Sicilia]"	This pub named The Phoenix is located in the city centre near Café Sicilia. It is kid friendly and serves French food with a price range of £20-25. It has a customer rating of 3 out of 5.
"name[The Phoenix], eatType[pub], food[French], priceRange[Â£20-25], customer rating[3 out of 5], area[riverside], familyFriendly[no], near[CafÃ© Sicilia]"	"Rated 3 out of 5, The Phoenix is a pub serving French food in the £20-25 price range. It is located in the riverside area near Café Sicilia and is not kid friendly."
"name[The Phoenix], eatType[pub], food[French], priceRange[Â£20-25], customer rating[3 out of 5], area[riverside], familyFriendly[yes], near[CafÃ© Sicilia]"	At the riverside near Café Sicilia is a pub called The Phoenix. It serves French food and has a customer rating of 3 out of 5. It is kids friendly and has a price range of £20-25.
"name[The Phoenix], eatType[pub], food[French], priceRange[Â£20-25], customer rating[3 out of 5], area[riverside], familyFriendly[yes], near[Crowne Plaza Hotel]"	At the riverside near Crowne Plaza Hotel is a pub called The Phoenix. It serves French food and has a customer rating of 3 out of 5. It is kids friendly and has a price range of £20-25.
"name[The Phoenix], eatType[pub], food[French], priceRange[Â£20-25], customer rating[high], area[city centre], familyFriendly[no], near[Crowne Plaza Hotel]"	The The Phoenix is a pub serving French food in the £20-25 price range with a high customer rating located in the city centre near Crowne Plaza Hotel.  It is not kid friendly.
"name[The Phoenix], eatType[pub], food[French], priceRange[Â£20-25], customer rating[high], area[city centre], familyFriendly[yes], near[Crowne Plaza Hotel]"	Crowne Plaza Hotel is a pub named The Phoenix that serves French food in the £20-25 price range with a high customer rating in the city centre and is kid friendly.
"name[The Phoenix], eatType[pub], food[French], priceRange[Â£20-25], customer rating[high], area[riverside], familyFriendly[no], near[Crowne Plaza Hotel]"	The Phoenix is a pub that serves French food in the riverside area. It is not kid friendly and has a high customer rating.  It is near Crowne Plaza Hotel and has a price range of £20-25.
"name[The Phoenix], eatType[pub], food[French], priceRange[Â£20-25], customer rating[high], area[riverside], familyFriendly[yes], near[Crowne Plaza Hotel]"	At the riverside near Crowne Plaza Hotel there is a pub called The Phoenix that serves French food and has a high customer rating. It is kids friendly and has a price range of £20-25.
"name[The Phoenix], eatType[pub], food[French], priceRange[cheap], area[riverside], familyFriendly[yes], near[Raja Indian Cuisine]"	"Situated on the riverside near Raja Indian Cuisine, The Phoenix is a family friendly pub that serves French food at a cheap price."
"name[The Phoenix], eatType[pub], food[French], priceRange[cheap], customer rating[5 out of 5], area[city centre], familyFriendly[no], near[Crowne Plaza Hotel]"	French food is served at The Phoenix pub which is not family-friendly.  It is located in the city centre near Crowne Plaza Hotel.  It is cheap and has a customer rating of 5 out of 5.
"name[The Phoenix], eatType[pub], food[French], priceRange[cheap], customer rating[5 out of 5], area[city centre], familyFriendly[yes], near[Crowne Plaza Hotel]"	There is a cheap pub that serves French food called The Phoenix in the city centre near Crowne Plaza Hotel. It is family-friendly and has a customer rating of 5 out of 5.
"name[The Phoenix], eatType[pub], food[French], priceRange[cheap], customer rating[5 out of 5], area[riverside], familyFriendly[no], near[Crowne Plaza Hotel]"	This pub in the riverside area near Crowne Plaza Hotel is called The Phoenix.  It serves French food and has a customer rating of 5 out of 5.  It is cheap and not family-friendly.
"name[The Phoenix], eatType[pub], food[French], priceRange[cheap], customer rating[5 out of 5], area[riverside], familyFriendly[yes], near[Crowne Plaza Hotel]"	On the riverside near Crowne Plaza Hotel is a pub called The Phoenix. It serves French food and is family friendly. It has a cheap price range and a customer rating of 5 out of 5.
"name[The Phoenix], eatType[pub], food[French], priceRange[high], area[riverside], familyFriendly[yes], near[Raja Indian Cuisine]"	Raja Indian Cuisine is a pub called The Phoenix that serves French food and is children friendly. It is in the high price range and is located in the riverside area.
"name[The Phoenix], eatType[pub], food[French], priceRange[high], customer rating[3 out of 5], area[city centre], familyFriendly[no], near[Crowne Plaza Hotel]"	This pub is not children friendly and is located in the city centre near Crowne Plaza Hotel.  It is a French pub named The Phoenix with a high price range and a customer rating of 3 out of 5.
"name[The Phoenix], eatType[pub], food[French], priceRange[high], customer rating[3 out of 5], area[city centre], familyFriendly[yes], near[Crowne Plaza Hotel]"	The The Phoenix is a children friendly pub serving French food in the high price range with a customer rating of 3 out of 5. It is located in the city centre near Crowne Plaza Hotel.
"name[The Phoenix], eatType[pub], food[French], priceRange[high], customer rating[3 out of 5], area[riverside], familyFriendly[no], near[Crowne Plaza Hotel]"	On the riverside near Crowne Plaza Hotel is a pub called The Phoenix. It serves French food and is not children friendly. It has a high price range and a customer rating of 3 out of 5.
"name[The Phoenix], eatType[pub], food[French], priceRange[high], customer rating[3 out of 5], area[riverside], familyFriendly[yes], near[Crowne Plaza Hotel]"	A high priced French pub near Crowne Plaza Hotel in the riverside area is called The Phoenix. It is children friendly and has a customer rating of 3 out of 5.
"name[The Phoenix], eatType[pub], food[French], priceRange[less than Â£20], customer rating[average], area[city centre], familyFriendly[no], near[Crowne Plaza Hotel]"	"This pub is not family-friendly, but is called The Phoenix.  It serves French food and has an average customer rating.  It is located in the city centre near Crowne Plaza Hotel.  The price range is less than £20."
"name[The Phoenix], eatType[pub], food[French], priceRange[less than Â£20], customer rating[average], area[city centre], familyFriendly[yes], near[Crowne Plaza Hotel]"	Family friendly The Phoenix is a pub serving French food in the city centre near Crowne Plaza Hotel.  It has an average customer rating and a price range of less than £20.
"name[The Phoenix], eatType[pub], food[French], priceRange[less than Â£20], customer rating[average], area[riverside], familyFriendly[no], near[Crowne Plaza Hotel]"	There is a pub named The Phoenix that serves French food for less than £20 in the riverside area near Crowne Plaza Hotel. It has an average customer rating and is not family friendly.
"name[The Phoenix], eatType[pub], food[French], priceRange[less than Â£20], customer rating[average], area[riverside], familyFriendly[yes], near[Crowne Plaza Hotel]"	At the riverside near Crowne Plaza Hotel is a pub called The Phoenix. It serves French food for less than £20 and is family friendly.
"name[The Phoenix], eatType[pub], food[French], priceRange[less than Â£20], customer rating[low], area[city centre], familyFriendly[no], near[Crowne Plaza Hotel]"	The Phoenix is a pub that serves French food for less than £20. It is located in the city centre near Crowne Plaza Hotel. It is not family-friendly and has a low customer rating.
"name[The Phoenix], eatType[pub], food[French], priceRange[less than Â£20], customer rating[low], area[city centre], familyFriendly[yes], near[Crowne Plaza Hotel]"	Family friendly French pub The Phoenix has a low customer rating and a price range of less than £20. It is located in the city centre near Crowne Plaza Hotel.
"name[The Phoenix], eatType[pub], food[French], priceRange[less than Â£20], customer rating[low], area[riverside], familyFriendly[no], near[Crowne Plaza Hotel]"	On the riverside near Crowne Plaza Hotel is The Phoenix pub.  It is not family-friendly and has a low customer rating.  It serves French food for less than £20.
"name[The Phoenix], eatType[pub], food[French], priceRange[less than Â£20], customer rating[low], area[riverside], familyFriendly[yes], near[Crowne Plaza Hotel]"	"Although it has a low customer rating, The Phoenix is a family friendly pub serving French food for less than £20. It is located in the riverside area near Crowne Plaza Hotel."
"name[The Phoenix], eatType[pub], food[French], priceRange[moderate], customer rating[1 out of 5], area[city centre], familyFriendly[no], near[Crowne Plaza Hotel]"	"Rated 1 out of 5, The Phoenix is a pub serving French food in the moderate price range in the city centre near Crowne Plaza Hotel. It is not kid friendly."
"name[The Phoenix], eatType[pub], food[French], priceRange[moderate], customer rating[1 out of 5], area[city centre], familyFriendly[yes], near[Crowne Plaza Hotel]"	A pub named The Phoenix is located in the city centre near Crowne Plaza Hotel. It is kid friendly and serves French food at a moderate price range. It has a customer rating of 1 out of 5.
"name[The Phoenix], eatType[pub], food[French], priceRange[moderate], customer rating[1 out of 5], area[riverside], familyFriendly[no], near[Crowne Plaza Hotel]"	"Rated 1 out of 5, The Phoenix is a pub that serves French food at a moderate price. It is located in the riverside area near Crowne Plaza Hotel and is not kid friendly."
"name[The Phoenix], eatType[pub], food[French], priceRange[moderate], customer rating[1 out of 5], area[riverside], familyFriendly[yes], near[Crowne Plaza Hotel]"	The The Phoenix is a pub that serves French food and is kids friendly. It is located near Crowne Plaza Hotel in the riverside area. It has a moderate price range and a customer rating of 1 out of 5.
"name[The Phoenix], eatType[pub], food[French], priceRange[more than Â£30], customer rating[5 out of 5], area[city centre], familyFriendly[no], near[Crowne Plaza Hotel]"	This pub is not children friendly and is located in the city centre near Crowne Plaza Hotel.  It is called The Phoenix and serves French food at a price range of more than £30. It has a customer rating of 5 out of 5.
"name[The Phoenix], eatType[pub], food[French], priceRange[more than Â£30], customer rating[5 out of 5], area[city centre], familyFriendly[yes], near[Crowne Plaza Hotel]"	This children friendly pub called The Phoenix serves French food and is located in the city centre near Crowne Plaza Hotel. It has a customer rating of 5 out of 5 and a price range of more than £30.
"name[The Phoenix], eatType[pub], food[French], priceRange[more than Â£30], customer rating[5 out of 5], area[riverside], familyFriendly[no], near[Crowne Plaza Hotel]"	Near Crowne Plaza Hotel in the riverside area is a pub called The Phoenix. It serves French food and has a customer rating of 5 out of 5. It is not children friendly and costs more than £30.
"name[The Phoenix], eatType[pub], food[French], priceRange[more than Â£30], customer rating[5 out of 5], area[riverside], familyFriendly[yes], near[Crowne Plaza Hotel]"	In the riverside area near Crowne Plaza Hotel is a child friendly pub called The Phoenix. It has a 5 out of 5 customer rating and a price range of more than £30.
"name[The Phoenix], eatType[pub], food[French], priceRange[more than Â£30], customer rating[low], area[city centre], familyFriendly[no], near[Crowne Plaza Hotel]"	"Located in the city centre near Crowne Plaza Hotel, The Phoenix is a pub that serves French food with a price range of more than £30. It is not children friendly and has a low customer rating."
"name[The Phoenix], eatType[pub], food[French], priceRange[more than Â£30], customer rating[low], area[city centre], familyFriendly[yes], near[Crowne Plaza Hotel]"	Children friendly French pub The Phoenix has a price range of more than £30 and a low customer rating. It is located in the city centre near Crowne Plaza Hotel.
"name[The Phoenix], eatType[pub], food[French], priceRange[more than Â£30], customer rating[low], area[riverside], familyFriendly[no], near[Crowne Plaza Hotel]"	Coffee shop The Phoenix is a French restaurant located in riverside near Crowne Plaza Hotel. It has a low customer rating and is not children friendly. The price range is more than £30.
"name[The Phoenix], eatType[pub], food[French], priceRange[more than Â£30], customer rating[low], area[riverside], familyFriendly[yes], near[Crowne Plaza Hotel]"	Children friendly French food pub The Phoenix has a price range of more than £30 and a low customer rating. It is located in the riverside area near Crowne Plaza Hotel.
"name[The Phoenix], eatType[restaurant], food[Fast food], priceRange[cheap], area[riverside], familyFriendly[yes], near[Raja Indian Cuisine]"	On the riverside near Raja Indian Cuisine is a family friendly restaurant called The Phoenix. It serves cheap Fast food food.
"name[The Phoenix], eatType[restaurant], food[Fast food], priceRange[high], area[city centre], familyFriendly[no], near[Raja Indian Cuisine]"	For a high priced Fast food restaurant then go to the The Phoenix located near Raja Indian Cuisine in the city centre.  It is not child friendly.
"name[The Phoenix], eatType[restaurant], food[Fast food], priceRange[high], area[city centre], familyFriendly[yes], near[Raja Indian Cuisine]"	An Fast food restaurant named The Phoenix is located near Raja Indian Cuisine in the city centre. It is children friendly and has a high price range.
"name[The Phoenix], eatType[restaurant], food[Fast food], priceRange[high], area[riverside], familyFriendly[no], near[Raja Indian Cuisine]"	At the riverside near Raja Indian Cuisine is a Fast food restaurant called The Phoenix. It is not children friendly and has a high price range.
"name[The Phoenix], eatType[restaurant], food[Fast food], priceRange[high], area[riverside], familyFriendly[yes], near[Raja Indian Cuisine]"	"For a high priced Fast food restaurant in the riverside area, try The Phoenix. It is children friendly and is located near Raja Indian Cuisine."
"name[The Phoenix], eatType[restaurant], food[Fast food], priceRange[less than Â£20], area[city centre], familyFriendly[no], near[Raja Indian Cuisine]"	An Fast food restaurant named The Phoenix is located near Raja Indian Cuisine in the city centre. It is not family-friendly and has a price range of less than £20.
"name[The Phoenix], eatType[restaurant], food[Fast food], priceRange[less than Â£20], area[city centre], familyFriendly[yes], near[Raja Indian Cuisine]"	Fast food restaurant The Phoenix is located in the city centre near Raja Indian Cuisine. It is family-friendly and is in the less than £20 price range.
"name[The Phoenix], eatType[restaurant], food[Fast food], priceRange[less than Â£20], area[riverside], familyFriendly[no], near[Raja Indian Cuisine]"	At the riverside near Raja Indian Cuisine is a Fast food restaurant called The Phoenix. It is not family-friendly and has a price range of less than £20.
"name[The Phoenix], eatType[restaurant], food[Fast food], priceRange[less than Â£20], area[riverside], familyFriendly[yes], near[Raja Indian Cuisine]"	The The Phoenix is a family friendly restaurant that serves Fast food food for less than £20. It is located in the riverside area near Raja Indian Cuisine.
"name[The Phoenix], eatType[restaurant], food[Fast food], priceRange[moderate], area[city centre], familyFriendly[no], near[Raja Indian Cuisine]"	An Fast food restaurant near Raja Indian Cuisine in the city centre is The Phoenix. It is not kid friendly and is moderately priced.
"name[The Phoenix], eatType[restaurant], food[Fast food], priceRange[moderate], area[city centre], familyFriendly[yes], near[Raja Indian Cuisine]"	Fast food restaurant The Phoenix is located in the city centre near Raja Indian Cuisine. It is a kid friendly restaurant with a moderate price range.
"name[The Phoenix], eatType[restaurant], food[Fast food], priceRange[moderate], area[riverside], familyFriendly[no], near[Raja Indian Cuisine]"	There is a moderately priced Fast food restaurant called The Phoenix located in riverside near Raja Indian Cuisine. It is not kids friendly.
"name[The Phoenix], eatType[restaurant], food[Fast food], priceRange[moderate], area[riverside], familyFriendly[yes], near[Raja Indian Cuisine]"	Riverside restaurant The Phoenix is a kid friendly restaurant that serves Fast food food at a moderate price range. It is located near Raja Indian Cuisine.
"name[The Phoenix], eatType[restaurant], food[Fast food], priceRange[more than Â£30], area[riverside], familyFriendly[yes], near[Raja Indian Cuisine]"	"For a child friendly restaurant that serves Fast food food and has a price range of more than £30, then The Phoenix is located near Raja Indian Cuisine in the riverside area."
"name[The Phoenix], eatType[restaurant], food[French], priceRange[Â£20-25], area[riverside], familyFriendly[yes], near[Raja Indian Cuisine]"	Kid friendly French restaurant The Phoenix is located near Raja Indian Cuisine in the riverside area. The price range is £20-25.
"name[The Phoenix], eatType[restaurant], food[French], priceRange[cheap], area[riverside], familyFriendly[yes], near[Raja Indian Cuisine]"	On the riverside near Raja Indian Cuisine is a family friendly restaurant called The Phoenix. It serves cheap French food.
"name[The Phoenix], eatType[restaurant], food[French], priceRange[high], area[riverside], familyFriendly[yes], near[Raja Indian Cuisine]"	"For a high priced French restaurant in the riverside area, try The Phoenix. It is children friendly and is located near Raja Indian Cuisine."
"name[The Phoenix], eatType[restaurant], food[Indian], priceRange[Â£20-25], customer rating[high], area[city centre], familyFriendly[no], near[Crowne Plaza Hotel]"	A high rated Indian restaurant in the city centre near Crowne Plaza Hotel is The Phoenix. It is not kid friendly and has a price range of £20-25.
"name[The Phoenix], eatType[restaurant], food[Indian], priceRange[Â£20-25], customer rating[high], area[city centre], familyFriendly[yes], near[Crowne Plaza Hotel]"	A high rated Indian restaurant in the city centre near Crowne Plaza Hotel is The Phoenix. It is kids friendly and has a price range of £20-25.
"name[The Phoenix], eatType[restaurant], food[Indian], priceRange[Â£20-25], customer rating[high], area[riverside], familyFriendly[no], near[Crowne Plaza Hotel]"	There is a high rated Indian restaurant near Crowne Plaza Hotel called The Phoenix which is not kid friendly and has a price range of £20-25.
"name[The Phoenix], eatType[restaurant], food[Indian], priceRange[Â£20-25], customer rating[high], area[riverside], familyFriendly[yes], near[Crowne Plaza Hotel]"	High rated Indian restaurant The Phoenix is located in the riverside area near Crowne Plaza Hotel. It is kid friendly.
"name[The Phoenix], eatType[restaurant], food[Indian], priceRange[cheap], customer rating[5 out of 5], area[city centre], familyFriendly[no], near[Crowne Plaza Hotel]"	The The Phoenix restaurant is a cheap Indian restaurant located in the city centre near Crowne Plaza Hotel.  It has a customer rating of 5 out of 5 and is not family-friendly.
"name[The Phoenix], eatType[restaurant], food[Indian], priceRange[cheap], customer rating[5 out of 5], area[city centre], familyFriendly[yes], near[Crowne Plaza Hotel]"	"For a cheap Indian restaurant in the city centre near Crowne Plaza Hotel, try The Phoenix. It is family friendly."
"name[The Phoenix], eatType[restaurant], food[Indian], priceRange[cheap], customer rating[5 out of 5], area[riverside], familyFriendly[no], near[Crowne Plaza Hotel]"	Riverside restaurant The Phoenix is a cheap Indian restaurant with a customer rating of 5 out of 5. It is not family friendly.
"name[The Phoenix], eatType[restaurant], food[Indian], priceRange[cheap], customer rating[5 out of 5], area[riverside], familyFriendly[no], near[Express by Holiday Inn]"	Riverside restaurant The Phoenix is a cheap Indian restaurant with a customer rating of 5 out of 5. It is not family friendly.
"name[The Phoenix], eatType[restaurant], food[Indian], priceRange[cheap], customer rating[5 out of 5], area[riverside], familyFriendly[yes], near[Express by Holiday Inn]"	This restaurant is located in the riverside area near the Express by Holiday Inn.  It is called The Phoenix and is family friendly.  It serves Indian food and has a cheap price range.
"name[The Phoenix], eatType[restaurant], food[Indian], priceRange[cheap], customer rating[average], area[city centre], familyFriendly[no], near[Express by Holiday Inn]"	The The Phoenix restaurant is a cheap Indian restaurant located in the city centre near the Express by Holiday Inn. It has an average customer rating and is not family-friendly.
"name[The Plough], eatType[pub], food[Chinese], priceRange[Â£20-25], area[riverside], familyFriendly[yes], near[Raja Indian Cuisine]"	On the riverside near Raja Indian Cuisine is a kid friendly pub called The Plough. It serves Chinese food and has a price range of £20-25.
"name[The Plough], eatType[pub], food[Chinese], priceRange[cheap], area[riverside], familyFriendly[yes], near[Raja Indian Cuisine]"	"Situated on the riverside near Raja Indian Cuisine, The Plough is a family friendly pub that serves Chinese food at a cheap price."
"name[The Plough], eatType[pub], food[Chinese], priceRange[high], area[city centre], familyFriendly[no], near[Raja Indian Cuisine]"	"Serving Chinese food at a high price range, The Plough is a pub located in the city centre near Raja Indian Cuisine. It is not child friendly."
"name[The Plough], eatType[pub], food[Chinese], priceRange[high], area[city centre], familyFriendly[yes], near[Raja Indian Cuisine]"	Chinese food is served at The Plough pub which is children friendly and is located in the city centre near Raja Indian Cuisine. It has a high price range.
"name[The Plough], eatType[pub], food[Chinese], priceRange[high], area[riverside], familyFriendly[no], near[Raja Indian Cuisine]"	"Situated near Raja Indian Cuisine in the riverside area, The Plough is a pub that serves Chinese food at a high price range. It is not child friendly."
"name[The Plough], eatType[pub], food[Chinese], priceRange[high], area[riverside], familyFriendly[yes], near[Raja Indian Cuisine]"	Raja Indian Cuisine is a pub called The Plough that serves Chinese food and is children friendly. It is in the high price range and is located in the riverside area.
"name[The Plough], eatType[pub], food[Chinese], priceRange[less than Â£20], area[city centre], familyFriendly[no], near[Raja Indian Cuisine]"	The Plough is a pub that serves Chinese food for less than £20. It is located in the city centre near Raja Indian Cuisine and is not family friendly.
"name[The Plough], eatType[restaurant], food[Chinese], priceRange[Â£20-25], area[riverside], familyFriendly[yes], near[Raja Indian Cuisine]"	Kid friendly Chinese restaurant The Plough is located near Raja Indian Cuisine in the riverside area. The price range is £20-25.
"name[The Plough], eatType[restaurant], food[Chinese], priceRange[cheap], area[riverside], familyFriendly[yes], near[Raja Indian Cuisine]"	On the riverside near Raja Indian Cuisine is a family friendly restaurant called The Plough. It serves cheap Chinese food.
"name[The Plough], eatType[restaurant], food[Chinese], priceRange[high], area[city centre], familyFriendly[no], near[Raja Indian Cuisine]"	For a high priced Chinese restaurant then go to the The Plough located near Raja Indian Cuisine in the city centre.  It is not child friendly.
"name[The Plough], eatType[restaurant], food[Chinese], priceRange[high], area[city centre], familyFriendly[yes], near[Raja Indian Cuisine]"	An Chinese restaurant named The Plough is located near Raja Indian Cuisine in the city centre. It is children friendly and has a high price range.
"name[The Plough], eatType[restaurant], food[Chinese], priceRange[high], area[riverside], familyFriendly[no], near[Raja Indian Cuisine]"	At the riverside near Raja Indian Cuisine is a Chinese restaurant called The Plough. It is not children friendly and has a high price range.
"name[The Plough], eatType[restaurant], food[Chinese], priceRange[high], area[riverside], familyFriendly[yes], near[Raja Indian Cuisine]"	"For a high priced Chinese restaurant in the riverside area, try The Plough. It is children friendly and is located near Raja Indian Cuisine."
"name[The Plough], eatType[restaurant], food[Chinese], priceRange[less than Â£20], area[city centre], familyFriendly[no], near[Raja Indian Cuisine]"	An Chinese restaurant named The Plough is located near Raja Indian Cuisine in the city centre. It is not family-friendly and has a price range of less than £20.
"name[The Punter], eatType[pub], food[Chinese], priceRange[less than Â£20], area[city centre], familyFriendly[yes], near[Raja Indian Cuisine]"	Family friendly The Punter is a pub that serves Chinese food for less than £20. It is located in the city centre near Raja Indian Cuisine.
"name[The Punter], eatType[pub], food[Chinese], priceRange[less than Â£20], area[riverside], familyFriendly[no], near[Raja Indian Cuisine]"	In the riverside area near Raja Indian Cuisine is a pub called The Punter. It serves Chinese food for less than £20. It is not family-friendly.
"name[The Punter], eatType[pub], food[Chinese], priceRange[less than Â£20], area[riverside], familyFriendly[yes], near[Raja Indian Cuisine]"	At the riverside near Raja Indian Cuisine is a pub called The Punter. It serves Chinese food for less than £20 and is family friendly.
"name[The Punter], eatType[pub], food[Chinese], priceRange[moderate], area[city centre], familyFriendly[no], near[Raja Indian Cuisine]"	The Punters is a pub that serves Chinese food in the moderate price range in the city centre near Raja Indian Cuisine and is not kid friendly.
"name[The Punter], eatType[pub], food[Chinese], priceRange[moderate], area[city centre], familyFriendly[yes], near[Raja Indian Cuisine]"	Near Raja Indian Cuisine is a pub called The Punter. It serves Chinese food and is kid friendly. It is in the city centre and has a moderate price range.
"name[The Punter], eatType[pub], food[Chinese], priceRange[moderate], area[riverside], familyFriendly[no], near[Raja Indian Cuisine]"	The The Punter is a pub that serves Chinese food at a moderate price range. It is not kid friendly and is located near Raja Indian Cuisine in the riverside area.
"name[The Punter], eatType[pub], food[Chinese], priceRange[moderate], area[riverside], familyFriendly[yes], near[Raja Indian Cuisine]"	On the riverside near Raja Indian Cuisine is a kid friendly pub called The Punter. It serves Chinese food and has a moderate price range.
"name[The Punter], eatType[pub], food[Chinese], priceRange[more than Â£30], area[riverside], familyFriendly[yes], near[Raja Indian Cuisine]"	By the riverside near Raja Indian Cuisine is a child friendly pub called The Punter. It serves Chinese food and has a price range of more than £30.
"name[The Punter], eatType[pub], food[English], priceRange[Â£20-25], area[riverside], familyFriendly[yes], near[Raja Indian Cuisine]"	On the riverside near Raja Indian Cuisine is a kid friendly pub called The Punter. It serves English food and has a price range of £20-25.
"name[The Punter], eatType[pub], food[English], priceRange[cheap], area[riverside], familyFriendly[yes], near[Raja Indian Cuisine]"	"Situated on the riverside near Raja Indian Cuisine, The Punter is a family friendly pub that serves English food at a cheap price."
"name[The Punter], eatType[pub], food[English], priceRange[high], area[city centre], familyFriendly[no], near[Raja Indian Cuisine]"	"Serving English food at a high price range, The Punter is a pub located in the city centre near Raja Indian Cuisine. It is not child friendly."
"name[The Punter], eatType[pub], food[English], priceRange[high], area[city centre], familyFriendly[yes], near[Raja Indian Cuisine]"	English food is served at The Punter pub which is children friendly and is located in the city centre near Raja Indian Cuisine. It has a high price range.
"name[The Punter], eatType[pub], food[English], priceRange[high], area[riverside], familyFriendly[no], near[Raja Indian Cuisine]"	"Situated near Raja Indian Cuisine in the riverside area, The Punter is a pub that serves English food at a high price range. It is not child friendly."
"name[The Punter], eatType[pub], food[English], priceRange[high], area[riverside], familyFriendly[yes], near[Raja Indian Cuisine]"	Raja Indian Cuisine is a pub called The Punter that serves English food and is children friendly. It is in the high price range and is located in the riverside area.
"name[The Punter], eatType[pub], food[Italian], priceRange[high], customer rating[average], area[city centre], familyFriendly[no], near[Rainbow Vegetarian CafÃ©]"	Italian food is served at The Punter pub with a high price range and an average customer rating. It is located in the city centre near Rainbow Vegetarian Café and is not children friendly.
"name[The Punter], eatType[restaurant], food[Chinese], priceRange[less than Â£20], area[city centre], familyFriendly[yes], near[Raja Indian Cuisine]"	Chinese restaurant The Punter is located in the city centre near Raja Indian Cuisine. It is family-friendly and is in the less than £20 price range.
"name[The Punter], eatType[restaurant], food[Chinese], priceRange[less than Â£20], area[riverside], familyFriendly[no], near[Raja Indian Cuisine]"	At the riverside near Raja Indian Cuisine is a Chinese restaurant called The Punter. It is not family-friendly and has a price range of less than £20.
"name[The Punter], eatType[restaurant], food[Chinese], priceRange[less than Â£20], area[riverside], familyFriendly[yes], near[Raja Indian Cuisine]"	The The Punter is a family friendly restaurant that serves Chinese food for less than £20. It is located in the riverside area near Raja Indian Cuisine.
"name[The Punter], eatType[restaurant], food[Chinese], priceRange[moderate], area[city centre], familyFriendly[no], near[Raja Indian Cuisine]"	An Chinese restaurant near Raja Indian Cuisine in the city centre is The Punter. It is not kid friendly and is moderately priced.
"name[The Punter], eatType[restaurant], food[Chinese], priceRange[moderate], area[city centre], familyFriendly[yes], near[Raja Indian Cuisine]"	Chinese restaurant The Punter is located in the city centre near Raja Indian Cuisine. It is a kid friendly restaurant with a moderate price range.
"name[The Punter], eatType[restaurant], food[Chinese], priceRange[moderate], area[riverside], familyFriendly[no], near[Raja Indian Cuisine]"	There is a moderately priced Chinese restaurant called The Punter located in riverside near Raja Indian Cuisine. It is not kids friendly.
"name[The Punter], eatType[restaurant], food[Chinese], priceRange[moderate], area[riverside], familyFriendly[yes], near[Raja Indian Cuisine]"	Riverside restaurant The Punter is a kid friendly restaurant that serves Chinese food at a moderate price range. It is located near Raja Indian Cuisine.
"name[The Punter], eatType[restaurant], food[Chinese], priceRange[more than Â£30], area[riverside], familyFriendly[yes], near[Raja Indian Cuisine]"	"For a child friendly restaurant that serves Chinese food and has a price range of more than £30, then The Punter is located near Raja Indian Cuisine in the riverside area."
"name[The Punter], eatType[restaurant], food[English], priceRange[Â£20-25], area[riverside], familyFriendly[yes], near[Raja Indian Cuisine]"	Kid friendly English restaurant The Punter is located near Raja Indian Cuisine in the riverside area. The price range is £20-25.
"name[The Punter], eatType[restaurant], food[English], priceRange[cheap], area[riverside], familyFriendly[yes], near[Raja Indian Cuisine]"	On the riverside near Raja Indian Cuisine is a family friendly restaurant called The Punter. It serves cheap English food.
"name[The Punter], eatType[restaurant], food[English], priceRange[high], area[city centre], familyFriendly[no], near[Raja Indian Cuisine]"	For a high priced English restaurant then go to the The Punter located near Raja Indian Cuisine in the city centre.  It is not child friendly.
"name[The Punter], eatType[restaurant], food[English], priceRange[high], area[city centre], familyFriendly[yes], near[Raja Indian Cuisine]"	An English restaurant named The Punter is located near Raja Indian Cuisine in the city centre. It is children friendly and has a high price range.
"name[The Punter], eatType[restaurant], food[English], priceRange[high], area[riverside], familyFriendly[no], near[Raja Indian Cuisine]"	At the riverside near Raja Indian Cuisine is a English restaurant called The Punter. It is not children friendly and has a high price range.
"name[The Punter], eatType[restaurant], food[English], priceRange[high], area[riverside], familyFriendly[yes], near[Raja Indian Cuisine]"	"For a high priced English restaurant in the riverside area, try The Punter. It is children friendly and is located near Raja Indian Cuisine."
"name[The Punter], eatType[restaurant], food[Indian], priceRange[cheap], customer rating[average], area[city centre], familyFriendly[yes], near[Express by Holiday Inn]"	"For a cheap Indian restaurant in the city centre near Express by Holiday Inn, The Punter is a great place to eat. It is family friendly."
"name[The Punter], eatType[restaurant], food[Indian], priceRange[cheap], customer rating[average], area[riverside], familyFriendly[no], near[Express by Holiday Inn]"	The The Punter restaurant is a cheap fast food restaurant located in riverside near Express by Holiday Inn.  It has an average customer rating and is not family friendly.
"name[The Punter], eatType[restaurant], food[Indian], priceRange[cheap], customer rating[average], area[riverside], familyFriendly[yes], near[Express by Holiday Inn]"	Cheap family friendly restaurant The Punter is located in the riverside area near Express by Holiday Inn. It has an average customer rating.
"name[The Punter], eatType[restaurant], food[Indian], priceRange[high], customer rating[1 out of 5], area[city centre], familyFriendly[no], near[Express by Holiday Inn]"	Indian restaurant The Punter is located in the city centre near Express by Holiday Inn. It is not children friendly and is in the high price range.
"name[The Punter], eatType[restaurant], food[Indian], priceRange[high], customer rating[1 out of 5], area[city centre], familyFriendly[yes], near[Express by Holiday Inn]"	There is a high priced Indian restaurant called The Punter located in the city centre near Express by Holiday Inn with a customer rating of 1 out of 5.
"name[The Punter], eatType[restaurant], food[Indian], priceRange[high], customer rating[1 out of 5], area[riverside], familyFriendly[no], near[Express by Holiday Inn]"	High priced Indian restaurant The Punter is located in the riverside area near Express by Holiday Inn. It is not child friendly.
"name[The Punter], eatType[restaurant], food[Indian], priceRange[high], customer rating[1 out of 5], area[riverside], familyFriendly[yes], near[Express by Holiday Inn]"	On the riverside near Express by Holiday Inn is a Indian restaurant called The Punter. It is children friendly and has a customer rating of 1 out of 5.
"name[The Punter], eatType[restaurant], food[Indian], priceRange[high], customer rating[average], area[city centre], familyFriendly[no], near[Express by Holiday Inn]"	A restaurant named The Punter is a high priced Indian restaurant located in the city centre near Express by Holiday Inn. It has an average customer rating and is not children friendly.
"name[The Punter], eatType[restaurant], food[Indian], priceRange[high], customer rating[average], area[city centre], familyFriendly[yes], near[Express by Holiday Inn]"	A children friendly restaurant named The Punter is located near Express by Holiday Inn in the city centre. It has an average customer rating and a high price range.
"name[The Punter], eatType[restaurant], food[Indian], priceRange[high], customer rating[average], area[riverside], familyFriendly[no], near[Express by Holiday Inn]"	High priced Indian restaurant The Punter is located in the riverside area near the Express by Holiday Inn. It has an average customer rating and is not children friendly.
"name[The Punter], eatType[restaurant], food[Indian], priceRange[high], customer rating[average], area[riverside], familyFriendly[yes], near[Express by Holiday Inn]"	The The Punter restaurant is a high priced restaurant located in the riverside area near the Express by Holiday Inn. It has an average customer rating and is children friendly.
"name[The Punter], eatType[restaurant], food[Indian], priceRange[less than Â£20], customer rating[low], area[city centre], familyFriendly[no], near[Express by Holiday Inn]"	A Indian restaurant near Express by Holiday Inn in the city centre is The Punter. It is not family-friendly and is in the less than £20 price range.
"name[The Punter], eatType[restaurant], food[Indian], priceRange[less than Â£20], customer rating[low], area[city centre], familyFriendly[yes], near[Express by Holiday Inn]"	This restaurant is located in the city centre near the Express by Holiday Inn.  It is called The Punter and is family-friendly.  It serves Indian food for less than £20.
"name[The Punter], eatType[restaurant], food[Indian], priceRange[less than Â£20], customer rating[low], area[riverside], familyFriendly[no], near[Express by Holiday Inn]"	At the riverside near Express by Holiday Inn is a Indian restaurant called The Punter. It is not family-friendly and has a price range of less than £20.
"name[The Punter], eatType[restaurant], food[Indian], priceRange[less than Â£20], customer rating[low], area[riverside], familyFriendly[yes], near[Express by Holiday Inn]"	Family friendly restaurant The Punter is located near Express by Holiday Inn in the riverside area. It has a low customer rating and a price range of less than £20.
"name[The Punter], eatType[restaurant], food[Indian], priceRange[moderate], customer rating[1 out of 5], area[city centre], familyFriendly[no], near[Express by Holiday Inn]"	An Indian restaurant named The Punter is located near Express by Holiday Inn in the city centre. It is not kid friendly and is moderately priced.
"name[The Punter], eatType[restaurant], food[Indian], priceRange[moderate], customer rating[1 out of 5], area[city centre], familyFriendly[yes], near[Express by Holiday Inn]"	For a moderate priced Indian restaurant that is kid friendly in the city centre near Express by Holiday Inn then go to The Punter
"name[The Punter], eatType[restaurant], food[Indian], priceRange[moderate], customer rating[1 out of 5], area[riverside], familyFriendly[no], near[Express by Holiday Inn]"	An Indian restaurant named The Punter is located near Express by Holiday Inn in the riverside area. It is not kid friendly and has a moderate price range.
"name[The Punter], eatType[restaurant], food[Indian], priceRange[moderate], customer rating[1 out of 5], area[riverside], familyFriendly[yes], near[Express by Holiday Inn]"	Come to The Punter restaurant for families with children and a low customer rating. It is located in riverside near Express by Holiday Inn and has a moderate price range.
"name[The Punter], eatType[restaurant], food[Indian], priceRange[moderate], customer rating[3 out of 5], area[city centre], familyFriendly[no], near[Express by Holiday Inn]"	An Indian restaurant near Express by Holiday Inn in the city centre is The Punter. It is not kid friendly and is moderately priced.
"name[The Punter], eatType[restaurant], food[Indian], priceRange[moderate], customer rating[3 out of 5], area[city centre], familyFriendly[yes], near[Express by Holiday Inn]"	Indian restaurant The Punter is located in the city centre near Express by Holiday Inn. It is a kid friendly restaurant with a moderate price range.
"name[The Punter], eatType[restaurant], food[Indian], priceRange[moderate], customer rating[3 out of 5], area[riverside], familyFriendly[no], near[Express by Holiday Inn]"	An Indian restaurant named The Punter is located near Express by Holiday Inn in the riverside area. It is not kid friendly and has a moderate price range.
"name[The Punter], eatType[restaurant], food[Indian], priceRange[moderate], customer rating[3 out of 5], area[riverside], familyFriendly[yes], near[Express by Holiday Inn]"	Riverside restaurant The Punter is a kid friendly restaurant with a moderate price range and a customer rating of 3 out of 5.  It is located near Express by Holiday Inn.
"name[The Punter], eatType[restaurant], food[Indian], priceRange[more than Â£30], customer rating[high], area[city centre], familyFriendly[no], near[Express by Holiday Inn]"	A high rated Indian restaurant in the city centre near Express by Holiday Inn is The Punter. It is not children friendly and has a price range of more than £30.
"name[The Punter], eatType[restaurant], food[Indian], priceRange[more than Â£30], customer rating[high], area[city centre], familyFriendly[yes], near[Express by Holiday Inn]"	A high rated Indian restaurant in the city centre near Express by Holiday Inn is The Punter. It is children friendly and has a price range of more than £30.
"name[The Punter], eatType[restaurant], food[Indian], priceRange[more than Â£30], customer rating[high], area[riverside], familyFriendly[no], near[Express by Holiday Inn]"	Riverside has a high rated restaurant called The Punter. It is not children friendly and is in the price range of more than £30. It is near Express by Holiday Inn.
"name[The Punter], eatType[restaurant], food[Indian], priceRange[more than Â£30], customer rating[high], area[riverside], familyFriendly[yes], near[Express by Holiday Inn]"	This children friendly restaurant named The Punter is located near Express by Holiday Inn in the riverside area. It serves Indian food and has a price range of more than £30.
"name[The Punter], eatType[restaurant], food[Italian], priceRange[Â£20-25], customer rating[high], area[city centre], familyFriendly[no], near[Express by Holiday Inn]"	A high rated Italian restaurant in the city centre near Express by Holiday Inn is The Punter. It is not kid friendly and has a price range of £20-25.
"name[The Punter], eatType[restaurant], food[Italian], priceRange[Â£20-25], customer rating[high], area[city centre], familyFriendly[yes], near[Express by Holiday Inn]"	A high rated Italian restaurant in the city centre near Express by Holiday Inn is The Punter. It is kids friendly and has a price range of £20-25.
"name[The Punter], eatType[restaurant], food[Italian], priceRange[Â£20-25], customer rating[high], area[riverside], familyFriendly[no], near[Express by Holiday Inn]"	There is a high rated Italian restaurant near Express by Holiday Inn called The Punter which is not kid friendly and has a price range of £20-25.
"name[The Punter], eatType[restaurant], food[Italian], priceRange[Â£20-25], customer rating[high], area[riverside], familyFriendly[yes], near[Express by Holiday Inn]"	High rated Italian restaurant The Punter is located in the riverside area near Express by Holiday Inn. It is kid friendly.
"name[The Punter], eatType[restaurant], food[Italian], priceRange[cheap], customer rating[5 out of 5], area[city centre], familyFriendly[no], near[Express by Holiday Inn]"	The The Punter restaurant is a cheap Italian restaurant located in the city centre near Express by Holiday Inn.  It has a customer rating of 5 out of 5 and is not family-friendly.
"name[The Punter], eatType[restaurant], food[Italian], priceRange[cheap], customer rating[5 out of 5], area[city centre], familyFriendly[no], near[Rainbow Vegetarian CafÃ©]"	The The Punter restaurant is a cheap Italian restaurant located in the city centre near Rainbow Vegetarian Café.  It has a customer rating of 5 out of 5 and is not family-friendly.
"name[The Punter], eatType[restaurant], food[Italian], priceRange[cheap], customer rating[5 out of 5], area[city centre], familyFriendly[yes], near[Rainbow Vegetarian CafÃ©]"	"For a cheap Italian restaurant in the city centre near Rainbow Vegetarian Café, try The Punter. It is family friendly."
"name[The Punter], eatType[restaurant], food[Italian], priceRange[cheap], customer rating[5 out of 5], area[riverside], familyFriendly[no], near[Rainbow Vegetarian CafÃ©]"	Riverside restaurant The Punter is a cheap Italian restaurant with a customer rating of 5 out of 5. It is not family friendly.
"name[The Punter], eatType[restaurant], food[Italian], priceRange[cheap], customer rating[5 out of 5], area[riverside], familyFriendly[yes], near[Rainbow Vegetarian CafÃ©]"	This restaurant is located in the riverside area near the Rainbow Vegetarian Café.  It is called The Punter and is family friendly.  It serves Italian food and has a cheap price range.
"name[The Punter], eatType[restaurant], food[Italian], priceRange[cheap], customer rating[average], area[city centre], familyFriendly[no], near[Rainbow Vegetarian CafÃ©]"	The The Punter restaurant is a cheap Italian restaurant located in the city centre near the Rainbow Vegetarian Café. It has an average customer rating and is not family-friendly.
"name[The Punter], eatType[restaurant], food[Italian], priceRange[cheap], customer rating[average], area[city centre], familyFriendly[yes], near[Rainbow Vegetarian CafÃ©]"	"For a cheap Italian restaurant in the city centre near Rainbow Vegetarian Café, The Punter is a great place to eat. It is family friendly."
"name[The Punter], eatType[restaurant], food[Italian], priceRange[cheap], customer rating[average], area[riverside], familyFriendly[no], near[Rainbow Vegetarian CafÃ©]"	The The Punter restaurant is a cheap fast food restaurant located in riverside near Rainbow Vegetarian Café.  It has an average customer rating and is not family friendly.
"name[The Punter], eatType[restaurant], food[Italian], priceRange[cheap], customer rating[average], area[riverside], familyFriendly[yes], near[Rainbow Vegetarian CafÃ©]"	Cheap family friendly restaurant The Punter is located in the riverside area near Rainbow Vegetarian Café. It has an average customer rating.
"name[The Punter], eatType[restaurant], food[Italian], priceRange[high], customer rating[1 out of 5], area[city centre], familyFriendly[no], near[Rainbow Vegetarian CafÃ©]"	Italian restaurant The Punter is located in the city centre near Rainbow Vegetarian Café. It is not children friendly and is in the high price range.
"name[The Punter], eatType[restaurant], food[Italian], priceRange[high], customer rating[1 out of 5], area[city centre], familyFriendly[yes], near[Rainbow Vegetarian CafÃ©]"	There is a high priced Italian restaurant called The Punter located in the city centre near Rainbow Vegetarian Café with a customer rating of 1 out of 5.
"name[The Punter], eatType[restaurant], food[Italian], priceRange[high], customer rating[1 out of 5], area[riverside], familyFriendly[no], near[Rainbow Vegetarian CafÃ©]"	High priced Italian restaurant The Punter is located in the riverside area near Rainbow Vegetarian Café. It is not child friendly.
"name[The Punter], eatType[restaurant], food[Italian], priceRange[high], customer rating[1 out of 5], area[riverside], familyFriendly[yes], near[Rainbow Vegetarian CafÃ©]"	On the riverside near Rainbow Vegetarian Café is a Italian restaurant called The Punter. It is children friendly and has a customer rating of 1 out of 5.
"name[The Vaults], eatType[pub], food[French], priceRange[high], area[riverside], familyFriendly[yes], near[Raja Indian Cuisine]"	Raja Indian Cuisine is a pub called The Vaults that serves French food and is children friendly. It is in the high price range and is located in the riverside area.
"name[The Vaults], eatType[pub], food[French], priceRange[less than Â£20], area[city centre], familyFriendly[no], near[Raja Indian Cuisine]"	The Vaults is a pub that serves French food for less than £20. It is located in the city centre near Raja Indian Cuisine and is not family friendly.
"name[The Vaults], eatType[pub], food[French], priceRange[less than Â£20], area[city centre], familyFriendly[yes], near[Raja Indian Cuisine]"	Family friendly The Vaults is a pub that serves French food for less than £20. It is located in the city centre near Raja Indian Cuisine.
"name[The Vaults], eatType[pub], food[French], priceRange[less than Â£20], area[riverside], familyFriendly[no], near[Raja Indian Cuisine]"	In the riverside area near Raja Indian Cuisine is a pub called The Vaults. It serves French food for less than £20. It is not family-friendly.
"name[The Vaults], eatType[pub], food[French], priceRange[less than Â£20], area[riverside], familyFriendly[yes], near[Raja Indian Cuisine]"	At the riverside near Raja Indian Cuisine is a pub called The Vaults. It serves French food for less than £20 and is family friendly.
"name[The Vaults], eatType[pub], food[French], priceRange[moderate], area[city centre], familyFriendly[no], near[Raja Indian Cuisine]"	The Vaultss is a pub that serves French food in the moderate price range in the city centre near Raja Indian Cuisine and is not kid friendly.
"name[The Vaults], eatType[pub], food[French], priceRange[moderate], area[city centre], familyFriendly[yes], near[Raja Indian Cuisine]"	Near Raja Indian Cuisine is a pub called The Vaults. It serves French food and is kid friendly. It is in the city centre and has a moderate price range.
"name[The Vaults], eatType[pub], food[French], priceRange[moderate], area[riverside], familyFriendly[no], near[Raja Indian Cuisine]"	The The Vaults is a pub that serves French food at a moderate price range. It is not kid friendly and is located near Raja Indian Cuisine in the riverside area.
"name[The Vaults], eatType[pub], food[French], priceRange[moderate], area[riverside], familyFriendly[yes], near[Raja Indian Cuisine]"	On the riverside near Raja Indian Cuisine is a kid friendly pub called The Vaults. It serves French food and has a moderate price range.
"name[The Vaults], eatType[pub], food[French], priceRange[more than Â£30], area[city centre], familyFriendly[no], near[Raja Indian Cuisine]"	The The Vaults is a pub serving French food in the city centre near Raja Indian Cuisine. It is not child friendly and has a price range of more than £30.
"name[The Vaults], eatType[pub], food[French], priceRange[more than Â£30], area[city centre], familyFriendly[yes], near[Raja Indian Cuisine]"	The The Vaults is a children friendly pub serving French food in the city centre near Raja Indian Cuisine. It has a price range of more than £30.
"name[The Vaults], eatType[pub], food[French], priceRange[more than Â£30], area[riverside], familyFriendly[no], near[Raja Indian Cuisine]"	Near Raja Indian Cuisine in the riverside area is a pub called The Vaults. It serves French food and is not children friendly. The price range is more than £30.
"name[The Vaults], eatType[pub], food[French], priceRange[more than Â£30], area[riverside], familyFriendly[yes], near[Raja Indian Cuisine]"	By the riverside near Raja Indian Cuisine is a child friendly pub called The Vaults. It serves French food and has a price range of more than £30.
"name[The Vaults], eatType[pub], food[Indian], priceRange[Â£20-25], area[riverside], familyFriendly[yes], near[Raja Indian Cuisine]"	On the riverside near Raja Indian Cuisine is a kid friendly pub called The Vaults. It serves Indian food and has a price range of £20-25.
"name[The Vaults], eatType[pub], food[Indian], priceRange[cheap], area[riverside], familyFriendly[yes], near[Raja Indian Cuisine]"	"Situated on the riverside near Raja Indian Cuisine, The Vaults is a family friendly pub that serves Indian food at a cheap price."
"name[The Vaults], eatType[pub], food[Indian], priceRange[high], area[city centre], familyFriendly[no], near[Raja Indian Cuisine]"	"Serving Indian food at a high price range, The Vaults is a pub located in the city centre near Raja Indian Cuisine. It is not child friendly."
"name[The Vaults], eatType[pub], food[Indian], priceRange[high], area[city centre], familyFriendly[yes], near[Raja Indian Cuisine]"	Indian food is served at The Vaults pub which is children friendly and is located in the city centre near Raja Indian Cuisine. It has a high price range.
"name[The Vaults], eatType[pub], food[Italian], priceRange[high], customer rating[average], area[city centre], familyFriendly[no], near[Rainbow Vegetarian CafÃ©]"	Italian food is served at The Vaults pub with a high price range and an average customer rating. It is located in the city centre near Rainbow Vegetarian Café and is not children friendly.
"name[The Vaults], eatType[pub], food[Italian], priceRange[high], customer rating[average], area[city centre], familyFriendly[yes], near[Rainbow Vegetarian CafÃ©]"	This pub named The Vaults is located in the city centre near Rainbow Vegetarian Café. It is children friendly and serves Italian food at a high price range. It has an average customer rating.
"name[The Vaults], eatType[pub], food[Italian], priceRange[high], customer rating[average], area[riverside], familyFriendly[no], near[Rainbow Vegetarian CafÃ©]"	At the riverside near Rainbow Vegetarian Café is a pub called The Vaults. It serves Italian food and has a high price range. It has an average customer rating and is not children friendly.
"name[The Vaults], eatType[pub], food[Italian], priceRange[high], customer rating[average], area[riverside], familyFriendly[yes], near[Rainbow Vegetarian CafÃ©]"	High priced Italian pub The Vaults is located in the riverside area near Rainbow Vegetarian Café. It has an average customer rating and is children friendly.
"name[The Vaults], eatType[pub], food[Italian], priceRange[less than Â£20], customer rating[low], area[city centre], familyFriendly[no], near[Rainbow Vegetarian CafÃ©]"	The Vaults is a pub that serves Italian food for less than £20. It is located in the city centre near Rainbow Vegetarian Café. It is not family-friendly and has a low customer rating.
"name[The Vaults], eatType[pub], food[Italian], priceRange[less than Â£20], customer rating[low], area[city centre], familyFriendly[yes], near[Rainbow Vegetarian CafÃ©]"	Family friendly Italian pub The Vaults has a low customer rating and a price range of less than £20. It is located in the city centre near Rainbow Vegetarian Café.
"name[The Vaults], eatType[pub], food[Italian], priceRange[less than Â£20], customer rating[low], area[riverside], familyFriendly[no], near[Rainbow Vegetarian CafÃ©]"	On the riverside near Rainbow Vegetarian Café is The Vaults pub.  It is not family-friendly and has a low customer rating.  It serves Italian food for less than £20.
"name[The Vaults], eatType[pub], food[Italian], priceRange[less than Â£20], customer rating[low], area[riverside], familyFriendly[yes], near[Rainbow Vegetarian CafÃ©]"	"Although it has a low customer rating, The Vaults is a family friendly pub serving Italian food for less than £20. It is located in the riverside area near Rainbow Vegetarian Café."
"name[The Vaults], eatType[pub], food[Italian], priceRange[moderate], customer rating[1 out of 5], area[city centre], familyFriendly[no], near[Rainbow Vegetarian CafÃ©]"	"Rated 1 out of 5, The Vaults is a pub serving Italian food in the moderate price range in the city centre near Rainbow Vegetarian Café. It is not kid friendly."
"name[The Vaults], eatType[pub], food[Italian], priceRange[moderate], customer rating[1 out of 5], area[city centre], familyFriendly[yes], near[Rainbow Vegetarian CafÃ©]"	A pub named The Vaults is located in the city centre near Rainbow Vegetarian Café. It is kid friendly and serves Italian food at a moderate price range. It has a customer rating of 1 out of 5.
"name[The Vaults], eatType[pub], food[Italian], priceRange[moderate], customer rating[1 out of 5], area[riverside], familyFriendly[no], near[Rainbow Vegetarian CafÃ©]"	"Rated 1 out of 5, The Vaults is a pub that serves Italian food at a moderate price. It is located in the riverside area near Rainbow Vegetarian Café and is not kid friendly."
"name[The Vaults], eatType[pub], food[Italian], priceRange[moderate], customer rating[1 out of 5], area[riverside], familyFriendly[yes], near[Rainbow Vegetarian CafÃ©]"	The The Vaults is a pub that serves Italian food and is kids friendly. It is located near Rainbow Vegetarian Café in the riverside area. It has a moderate price range and a customer rating of 1 out of 5.
"name[The Vaults], eatType[pub], food[Italian], priceRange[moderate], customer rating[3 out of 5], area[city centre], familyFriendly[no], near[Rainbow Vegetarian CafÃ©]"	"Serving Italian food, The Vaults is a pub with a moderate price range in the city centre near Rainbow Vegetarian Café. It is not kid friendly and has a customer rating of 3 out of 5."
"name[The Vaults], eatType[pub], food[Italian], priceRange[moderate], customer rating[3 out of 5], area[city centre], familyFriendly[yes], near[Rainbow Vegetarian CafÃ©]"	There is a moderately priced Italian pub near Rainbow Vegetarian Café in the city centre called The Vaults. It is kid friendly and has a customer rating of 3 out of 5.
"name[The Vaults], eatType[pub], food[Italian], priceRange[moderate], customer rating[3 out of 5], area[riverside], familyFriendly[no], near[Rainbow Vegetarian CafÃ©]"	A pub named The Vaults is located near Rainbow Vegetarian Café in the riverside area. It serves Italian food and has a moderate price range. It is not kid friendly and has a customer rating of 3 out of 5.
"name[The Vaults], eatType[pub], food[Italian], priceRange[moderate], customer rating[3 out of 5], area[riverside], familyFriendly[yes], near[Rainbow Vegetarian CafÃ©]"	At the riverside near Rainbow Vegetarian Café is a pub called The Vaults. It serves Italian food and has a moderate price range. It is kid friendly and has a customer rating of 3 out of 5.
"name[The Vaults], eatType[pub], food[Italian], priceRange[more than Â£30], customer rating[high], area[city centre], familyFriendly[no], near[Rainbow Vegetarian CafÃ©]"	"Located in the city centre near Rainbow Vegetarian Café, The Vaults is a pub that serves Italian food with a price range of more than £30. It has a high customer rating and is not child friendly."
"name[The Vaults], eatType[pub], food[Italian], priceRange[more than Â£30], customer rating[high], area[city centre], familyFriendly[yes], near[Rainbow Vegetarian CafÃ©]"	The Vaults is a children friendly pub serving Italian food in the city centre near Rainbow Vegetarian Café. It has a high customer rating and a price range of more than £30.
"name[The Vaults], eatType[pub], food[Italian], priceRange[more than Â£30], customer rating[high], area[riverside], familyFriendly[no], near[Rainbow Vegetarian CafÃ©]"	In the riverside area near Rainbow Vegetarian Café is a pub called The Vaults. It serves Italian food and has a high customer rating. It is not children friendly and the price range is more than £30.
"name[The Vaults], eatType[pub], food[Italian], priceRange[more than Â£30], customer rating[high], area[riverside], familyFriendly[yes], near[Rainbow Vegetarian CafÃ©]"	In the riverside area near Rainbow Vegetarian Café is a pub called The Vaults. It is children friendly and has a high customer rating. The price range is more than £30.
"name[The Vaults], eatType[pub], food[Japanese], priceRange[Â£20-25], customer rating[3 out of 5], area[city centre], familyFriendly[no], near[Rainbow Vegetarian CafÃ©]"	The Vaults is a pub serving Japanese food in the £20-25 price range. It is located in the city centre near Rainbow Vegetarian Café and is not kid friendly. It has a customer rating of 3 out of 5.
"name[The Vaults], eatType[pub], food[Japanese], priceRange[Â£20-25], customer rating[3 out of 5], area[city centre], familyFriendly[yes], near[Rainbow Vegetarian CafÃ©]"	This pub named The Vaults is located in the city centre near Rainbow Vegetarian Café. It is kid friendly and serves Japanese food with a price range of £20-25. It has a customer rating of 3 out of 5.
"name[The Vaults], eatType[pub], food[Japanese], priceRange[Â£20-25], customer rating[3 out of 5], area[riverside], familyFriendly[no], near[Rainbow Vegetarian CafÃ©]"	"Rated 3 out of 5, The Vaults is a pub serving Japanese food in the £20-25 price range. It is located in the riverside area near Rainbow Vegetarian Café and is not kid friendly."
"name[The Vaults], eatType[pub], food[Japanese], priceRange[Â£20-25], customer rating[3 out of 5], area[riverside], familyFriendly[yes], near[Rainbow Vegetarian CafÃ©]"	At the riverside near Rainbow Vegetarian Café is a pub called The Vaults. It serves Japanese food and has a customer rating of 3 out of 5. It is kids friendly and has a price range of £20-25.
"name[The Vaults], eatType[pub], food[Japanese], priceRange[Â£20-25], customer rating[high], area[city centre], familyFriendly[no], near[Rainbow Vegetarian CafÃ©]"	The The Vaults is a pub serving Japanese food in the £20-25 price range with a high customer rating located in the city centre near Rainbow Vegetarian Café.  It is not kid friendly.
"name[The Vaults], eatType[pub], food[Japanese], priceRange[Â£20-25], customer rating[high], area[city centre], familyFriendly[yes], near[Rainbow Vegetarian CafÃ©]"	Rainbow Vegetarian Café is a pub named The Vaults that serves Japanese food in the £20-25 price range with a high customer rating in the city centre and is kid friendly.
"name[The Vaults], eatType[pub], food[Japanese], priceRange[Â£20-25], customer rating[high], area[riverside], familyFriendly[no], near[Rainbow Vegetarian CafÃ©]"	The Vaults is a pub that serves Japanese food in the riverside area. It is not kid friendly and has a high customer rating.  It is near Rainbow Vegetarian Café and has a price range of £20-25.
"name[The Vaults], eatType[pub], food[Japanese], priceRange[Â£20-25], customer rating[high], area[riverside], familyFriendly[no], near[Raja Indian Cuisine]"	The Vaults is a pub that serves Japanese food in the riverside area. It is not kid friendly and has a high customer rating.  It is near Raja Indian Cuisine and has a price range of £20-25.
"name[The Vaults], eatType[pub], food[Japanese], priceRange[Â£20-25], customer rating[high], area[riverside], familyFriendly[yes], near[Raja Indian Cuisine]"	At the riverside near Raja Indian Cuisine there is a pub called The Vaults that serves Japanese food and has a high customer rating. It is kids friendly and has a price range of £20-25.
"name[The Vaults], eatType[pub], food[Japanese], priceRange[cheap], customer rating[5 out of 5], area[city centre], familyFriendly[no], near[Raja Indian Cuisine]"	Japanese food is served at The Vaults pub which is not family-friendly.  It is located in the city centre near Raja Indian Cuisine.  It is cheap and has a customer rating of 5 out of 5.
"name[The Vaults], eatType[pub], food[Japanese], priceRange[cheap], customer rating[5 out of 5], area[city centre], familyFriendly[yes], near[Raja Indian Cuisine]"	There is a cheap pub that serves Japanese food called The Vaults in the city centre near Raja Indian Cuisine. It is family-friendly and has a customer rating of 5 out of 5.
"name[The Vaults], eatType[pub], food[Japanese], priceRange[cheap], customer rating[5 out of 5], area[riverside], familyFriendly[no], near[Raja Indian Cuisine]"	This pub in the riverside area near Raja Indian Cuisine is called The Vaults.  It serves Japanese food and has a customer rating of 5 out of 5.  It is cheap and not family-friendly.
"name[The Vaults], eatType[pub], food[Japanese], priceRange[cheap], customer rating[5 out of 5], area[riverside], familyFriendly[yes], near[Raja Indian Cuisine]"	On the riverside near Raja Indian Cuisine is a pub called The Vaults. It serves Japanese food and is family friendly. It has a cheap price range and a customer rating of 5 out of 5.
"name[The Vaults], eatType[pub], food[Japanese], priceRange[high], customer rating[3 out of 5], area[city centre], familyFriendly[no], near[Raja Indian Cuisine]"	This pub is not children friendly and is located in the city centre near Raja Indian Cuisine.  It is a Japanese pub named The Vaults with a high price range and a customer rating of 3 out of 5.
"name[The Vaults], eatType[pub], food[Japanese], priceRange[high], customer rating[3 out of 5], area[city centre], familyFriendly[yes], near[Raja Indian Cuisine]"	The The Vaults is a children friendly pub serving Japanese food in the high price range with a customer rating of 3 out of 5. It is located in the city centre near Raja Indian Cuisine.
"name[The Vaults], eatType[pub], food[Japanese], priceRange[high], customer rating[3 out of 5], area[riverside], familyFriendly[no], near[Raja Indian Cuisine]"	On the riverside near Raja Indian Cuisine is a pub called The Vaults. It serves Japanese food and is not children friendly. It has a high price range and a customer rating of 3 out of 5.
"name[The Vaults], eatType[pub], food[Japanese], priceRange[high], customer rating[3 out of 5], area[riverside], familyFriendly[yes], near[Raja Indian Cuisine]"	A high priced Japanese pub near Raja Indian Cuisine in the riverside area is called The Vaults. It is children friendly and has a customer rating of 3 out of 5.
"name[The Vaults], eatType[pub], food[Japanese], priceRange[less than Â£20], customer rating[average], area[city centre], familyFriendly[no], near[Raja Indian Cuisine]"	"This pub is not family-friendly, but is called The Vaults.  It serves Japanese food and has an average customer rating.  It is located in the city centre near Raja Indian Cuisine.  The price range is less than £20."
"name[The Vaults], eatType[pub], food[Japanese], priceRange[less than Â£20], customer rating[average], area[city centre], familyFriendly[yes], near[Raja Indian Cuisine]"	Family friendly The Vaults is a pub serving Japanese food in the city centre near Raja Indian Cuisine.  It has an average customer rating and a price range of less than £20.
"name[The Vaults], eatType[pub], food[Japanese], priceRange[less than Â£20], customer rating[average], area[riverside], familyFriendly[no], near[Raja Indian Cuisine]"	There is a pub named The Vaults that serves Japanese food for less than £20 in the riverside area near Raja Indian Cuisine. It has an average customer rating and is not family friendly.
"name[The Vaults], eatType[pub], food[Japanese], priceRange[less than Â£20], customer rating[average], area[riverside], familyFriendly[yes], near[Raja Indian Cuisine]"	At the riverside near Raja Indian Cuisine is a pub called The Vaults. It serves Japanese food for less than £20 and is family friendly.
"name[The Vaults], eatType[pub], food[Japanese], priceRange[less than Â£20], customer rating[low], area[city centre], familyFriendly[no], near[Raja Indian Cuisine]"	The Vaults is a pub that serves Japanese food for less than £20. It is located in the city centre near Raja Indian Cuisine. It is not family-friendly and has a low customer rating.
"name[The Vaults], eatType[pub], food[Japanese], priceRange[less than Â£20], customer rating[low], area[city centre], familyFriendly[yes], near[Raja Indian Cuisine]"	Family friendly Japanese pub The Vaults has a low customer rating and a price range of less than £20. It is located in the city centre near Raja Indian Cuisine.
"name[The Vaults], eatType[pub], food[Japanese], priceRange[less than Â£20], customer rating[low], area[riverside], familyFriendly[no], near[Raja Indian Cuisine]"	On the riverside near Raja Indian Cuisine is The Vaults pub.  It is not family-friendly and has a low customer rating.  It serves Japanese food for less than £20.
"name[The Vaults], eatType[pub], food[Japanese], priceRange[less than Â£20], customer rating[low], area[riverside], familyFriendly[yes], near[Raja Indian Cuisine]"	"Although it has a low customer rating, The Vaults is a family friendly pub serving Japanese food for less than £20. It is located in the riverside area near Raja Indian Cuisine."
"name[The Vaults], eatType[pub], food[Japanese], priceRange[moderate], customer rating[1 out of 5], area[city centre], familyFriendly[no], near[Raja Indian Cuisine]"	"Rated 1 out of 5, The Vaults is a pub serving Japanese food in the moderate price range in the city centre near Raja Indian Cuisine. It is not kid friendly."
"name[The Vaults], eatType[pub], food[Japanese], priceRange[moderate], customer rating[1 out of 5], area[city centre], familyFriendly[yes], near[Raja Indian Cuisine]"	A pub named The Vaults is located in the city centre near Raja Indian Cuisine. It is kid friendly and serves Japanese food at a moderate price range. It has a customer rating of 1 out of 5.
"name[The Vaults], eatType[restaurant], food[French], priceRange[high], area[riverside], familyFriendly[yes], near[Raja Indian Cuisine]"	"For a high priced French restaurant in the riverside area, try The Vaults. It is children friendly and is located near Raja Indian Cuisine."
"name[The Vaults], eatType[restaurant], food[French], priceRange[less than Â£20], area[city centre], familyFriendly[no], near[Raja Indian Cuisine]"	An French restaurant named The Vaults is located near Raja Indian Cuisine in the city centre. It is not family-friendly and has a price range of less than £20.
"name[The Vaults], eatType[restaurant], food[French], priceRange[less than Â£20], area[city centre], familyFriendly[yes], near[Raja Indian Cuisine]"	French restaurant The Vaults is located in the city centre near Raja Indian Cuisine. It is family-friendly and is in the less than £20 price range.
"name[The Vaults], eatType[restaurant], food[French], priceRange[less than Â£20], area[riverside], familyFriendly[no], near[Raja Indian Cuisine]"	At the riverside near Raja Indian Cuisine is a French restaurant called The Vaults. It is not family-friendly and has a price range of less than £20.
"name[The Vaults], eatType[restaurant], food[French], priceRange[less than Â£20], area[riverside], familyFriendly[yes], near[Raja Indian Cuisine]"	The The Vaults is a family friendly restaurant that serves French food for less than £20. It is located in the riverside area near Raja Indian Cuisine.
"name[The Vaults], eatType[restaurant], food[French], priceRange[moderate], area[city centre], familyFriendly[no], near[Raja Indian Cuisine]"	An French restaurant near Raja Indian Cuisine in the city centre is The Vaults. It is not kid friendly and is moderately priced.
"name[The Vaults], eatType[restaurant], food[French], priceRange[moderate], area[city centre], familyFriendly[yes], near[Raja Indian Cuisine]"	French restaurant The Vaults is located in the city centre near Raja Indian Cuisine. It is a kid friendly restaurant with a moderate price range.
"name[The Vaults], eatType[restaurant], food[French], priceRange[moderate], area[riverside], familyFriendly[no], near[Raja Indian Cuisine]"	There is a moderately priced French restaurant called The Vaults located in riverside near Raja Indian Cuisine. It is not kids friendly.
"name[The Vaults], eatType[restaurant], food[French], priceRange[moderate], area[riverside], familyFriendly[yes], near[Raja Indian Cuisine]"	Riverside restaurant The Vaults is a kid friendly restaurant that serves French food at a moderate price range. It is located near Raja Indian Cuisine.
"name[The Vaults], eatType[restaurant], food[French], priceRange[more than Â£30], area[city centre], familyFriendly[no], near[Raja Indian Cuisine]"	An French restaurant near Raja Indian Cuisine in the city centre is The Vaults. It is not child friendly and has a price range of more than £30.
"name[The Vaults], eatType[restaurant], food[French], priceRange[more than Â£30], area[city centre], familyFriendly[yes], near[Raja Indian Cuisine]"	A children friendly French restaurant named The Vaults is located near Raja Indian Cuisine in the city centre. It has a price range of more than £30.
"name[The Vaults], eatType[restaurant], food[French], priceRange[more than Â£30], area[riverside], familyFriendly[no], near[Raja Indian Cuisine]"	Near Raja Indian Cuisine is a French restaurant called The Vaults in riverside. It is not children friendly and the price range is more than £30.
"name[The Vaults], eatType[restaurant], food[French], priceRange[more than Â£30], area[riverside], familyFriendly[yes], near[Raja Indian Cuisine]"	"For a child friendly restaurant that serves French food and has a price range of more than £30, then The Vaults is located near Raja Indian Cuisine in the riverside area."
"name[The Vaults], eatType[restaurant], food[Indian], priceRange[Â£20-25], area[riverside], familyFriendly[yes], near[Raja Indian Cuisine]"	Kid friendly Indian restaurant The Vaults is located near Raja Indian Cuisine in the riverside area. The price range is £20-25.
"name[The Vaults], eatType[restaurant], food[Indian], priceRange[cheap], area[riverside], familyFriendly[yes], near[Raja Indian Cuisine]"	On the riverside near Raja Indian Cuisine is a family friendly restaurant called The Vaults. It serves cheap Indian food.
"name[The Vaults], eatType[restaurant], food[Indian], priceRange[high], area[city centre], familyFriendly[no], near[Raja Indian Cuisine]"	For a high priced Indian restaurant then go to the The Vaults located near Raja Indian Cuisine in the city centre.  It is not child friendly.
"name[The Vaults], eatType[restaurant], food[Indian], priceRange[high], area[city centre], familyFriendly[yes], near[Raja Indian Cuisine]"	An Indian restaurant named The Vaults is located near Raja Indian Cuisine in the city centre. It is children friendly and has a high price range.
"name[The Waterman], eatType[pub], food[Indian], priceRange[high], area[city centre], familyFriendly[yes], near[Raja Indian Cuisine]"	Indian food is served at The Waterman pub which is children friendly and is located in the city centre near Raja Indian Cuisine. It has a high price range.
"name[The Waterman], eatType[pub], food[Indian], priceRange[high], area[riverside], familyFriendly[no], near[Raja Indian Cuisine]"	"Situated near Raja Indian Cuisine in the riverside area, The Waterman is a pub that serves Indian food at a high price range. It is not child friendly."
"name[The Waterman], eatType[pub], food[Indian], priceRange[high], area[riverside], familyFriendly[yes], near[Raja Indian Cuisine]"	Raja Indian Cuisine is a pub called The Waterman that serves Indian food and is children friendly. It is in the high price range and is located in the riverside area.
"name[The Waterman], eatType[pub], food[Indian], priceRange[less than Â£20], area[city centre], familyFriendly[no], near[Raja Indian Cuisine]"	The Waterman is a pub that serves Indian food for less than £20. It is located in the city centre near Raja Indian Cuisine and is not family friendly.
"name[The Waterman], eatType[pub], food[Indian], priceRange[less than Â£20], area[city centre], familyFriendly[yes], near[Raja Indian Cuisine]"	Family friendly The Waterman is a pub that serves Indian food for less than £20. It is located in the city centre near Raja Indian Cuisine.
"name[The Waterman], eatType[pub], food[Indian], priceRange[less than Â£20], area[riverside], familyFriendly[no], near[Raja Indian Cuisine]"	In the riverside area near Raja Indian Cuisine is a pub called The Waterman. It serves Indian food for less than £20. It is not family-friendly.
"name[The Waterman], eatType[pub], food[Indian], priceRange[less than Â£20], area[riverside], familyFriendly[yes], near[Raja Indian Cuisine]"	At the riverside near Raja Indian Cuisine is a pub called The Waterman. It serves Indian food for less than £20 and is family friendly.
"name[The Waterman], eatType[pub], food[Indian], priceRange[moderate], area[city centre], familyFriendly[no], near[Raja Indian Cuisine]"	The Watermans is a pub that serves Indian food in the moderate price range in the city centre near Raja Indian Cuisine and is not kid friendly.
"name[The Waterman], eatType[pub], food[Indian], priceRange[moderate], area[city centre], familyFriendly[yes], near[Raja Indian Cuisine]"	Near Raja Indian Cuisine is a pub called The Waterman. It serves Indian food and is kid friendly. It is in the city centre and has a moderate price range.
"name[The Waterman], eatType[pub], food[Indian], priceRange[moderate], area[riverside], familyFriendly[no], near[Raja Indian Cuisine]"	The The Waterman is a pub that serves Indian food at a moderate price range. It is not kid friendly and is located near Raja Indian Cuisine in the riverside area.
"name[The Waterman], eatType[pub], food[Indian], priceRange[moderate], area[riverside], familyFriendly[yes], near[Raja Indian Cuisine]"	On the riverside near Raja Indian Cuisine is a kid friendly pub called The Waterman. It serves Indian food and has a moderate price range.
"name[The Waterman], eatType[pub], food[Indian], priceRange[more than Â£30], area[riverside], familyFriendly[yes], near[Raja Indian Cuisine]"	By the riverside near Raja Indian Cuisine is a child friendly pub called The Waterman. It serves Indian food and has a price range of more than £30.
"name[The Waterman], eatType[pub], food[Italian], priceRange[Â£20-25], area[riverside], familyFriendly[yes], near[Raja Indian Cuisine]"	On the riverside near Raja Indian Cuisine is a kid friendly pub called The Waterman. It serves Italian food and has a price range of £20-25.
"name[The Waterman], eatType[pub], food[Italian], priceRange[cheap], area[riverside], familyFriendly[yes], near[Raja Indian Cuisine]"	"Situated on the riverside near Raja Indian Cuisine, The Waterman is a family friendly pub that serves Italian food at a cheap price."
"name[The Waterman], eatType[pub], food[Italian], priceRange[high], area[city centre], familyFriendly[no], near[Raja Indian Cuisine]"	"Serving Italian food at a high price range, The Waterman is a pub located in the city centre near Raja Indian Cuisine. It is not child friendly."
"name[The Waterman], eatType[pub], food[Italian], priceRange[high], area[city centre], familyFriendly[yes], near[Raja Indian Cuisine]"	Italian food is served at The Waterman pub which is children friendly and is located in the city centre near Raja Indian Cuisine. It has a high price range.
"name[The Waterman], eatType[pub], food[Italian], priceRange[high], area[riverside], familyFriendly[no], near[Raja Indian Cuisine]"	"Situated near Raja Indian Cuisine in the riverside area, The Waterman is a pub that serves Italian food at a high price range. It is not child friendly."
"name[The Waterman], eatType[pub], food[Italian], priceRange[high], area[riverside], familyFriendly[yes], near[Raja Indian Cuisine]"	Raja Indian Cuisine is a pub called The Waterman that serves Italian food and is children friendly. It is in the high price range and is located in the riverside area.
"name[The Waterman], eatType[pub], food[Italian], priceRange[less than Â£20], area[city centre], familyFriendly[no], near[Raja Indian Cuisine]"	The Waterman is a pub that serves Italian food for less than £20. It is located in the city centre near Raja Indian Cuisine and is not family friendly.
"name[The Waterman], eatType[pub], food[Italian], priceRange[less than Â£20], area[city centre], familyFriendly[yes], near[Raja Indian Cuisine]"	Family friendly The Waterman is a pub that serves Italian food for less than £20. It is located in the city centre near Raja Indian Cuisine.
"name[The Waterman], eatType[pub], food[Italian], priceRange[less than Â£20], area[riverside], familyFriendly[no], near[Raja Indian Cuisine]"	In the riverside area near Raja Indian Cuisine is a pub called The Waterman. It serves Italian food for less than £20. It is not family-friendly.
"name[The Waterman], eatType[restaurant], food[Indian], priceRange[high], area[city centre], familyFriendly[yes], near[Raja Indian Cuisine]"	An Indian restaurant named The Waterman is located near Raja Indian Cuisine in the city centre. It is children friendly and has a high price range.
"name[The Waterman], eatType[restaurant], food[Indian], priceRange[high], area[riverside], familyFriendly[no], near[Raja Indian Cuisine]"	At the riverside near Raja Indian Cuisine is a Indian restaurant called The Waterman. It is not children friendly and has a high price range.
"name[The Waterman], eatType[restaurant], food[Indian], priceRange[high], area[riverside], familyFriendly[yes], near[Raja Indian Cuisine]"	"For a high priced Indian restaurant in the riverside area, try The Waterman. It is children friendly and is located near Raja Indian Cuisine."
"name[The Waterman], eatType[restaurant], food[Indian], priceRange[less than Â£20], area[city centre], familyFriendly[no], near[Raja Indian Cuisine]"	An Indian restaurant named The Waterman is located near Raja Indian Cuisine in the city centre. It is not family-friendly and has a price range of less than £20.
"name[The Waterman], eatType[restaurant], food[Indian], priceRange[less than Â£20], area[city centre], familyFriendly[yes], near[Raja Indian Cuisine]"	Indian restaurant The Waterman is located in the city centre near Raja Indian Cuisine. It is family-friendly and is in the less than £20 price range.
"name[The Waterman], eatType[restaurant], food[Indian], priceRange[less than Â£20], area[riverside], familyFriendly[no], near[Raja Indian Cuisine]"	At the riverside near Raja Indian Cuisine is a Indian restaurant called The Waterman. It is not family-friendly and has a price range of less than £20.
"name[The Waterman], eatType[restaurant], food[Indian], priceRange[less than Â£20], area[riverside], familyFriendly[yes], near[Raja Indian Cuisine]"	The The Waterman is a family friendly restaurant that serves Indian food for less than £20. It is located in the riverside area near Raja Indian Cuisine.
"name[The Waterman], eatType[restaurant], food[Indian], priceRange[moderate], area[city centre], familyFriendly[no], near[Raja Indian Cuisine]"	An Indian restaurant near Raja Indian Cuisine in the city centre is The Waterman. It is not kid friendly and is moderately priced.
"name[The Waterman], eatType[restaurant], food[Indian], priceRange[moderate], area[city centre], familyFriendly[yes], near[Raja Indian Cuisine]"	Indian restaurant The Waterman is located in the city centre near Raja Indian Cuisine. It is a kid friendly restaurant with a moderate price range.
"name[The Waterman], eatType[restaurant], food[Indian], priceRange[moderate], area[riverside], familyFriendly[no], near[Raja Indian Cuisine]"	There is a moderately priced Indian restaurant called The Waterman located in riverside near Raja Indian Cuisine. It is not kids friendly.
"name[The Waterman], eatType[restaurant], food[Indian], priceRange[moderate], area[riverside], familyFriendly[yes], near[Raja Indian Cuisine]"	Riverside restaurant The Waterman is a kid friendly restaurant that serves Indian food at a moderate price range. It is located near Raja Indian Cuisine.
"name[The Waterman], eatType[restaurant], food[Indian], priceRange[more than Â£30], area[riverside], familyFriendly[yes], near[Raja Indian Cuisine]"	"For a child friendly restaurant that serves Indian food and has a price range of more than £30, then The Waterman is located near Raja Indian Cuisine in the riverside area."
"name[The Waterman], eatType[restaurant], food[Italian], priceRange[Â£20-25], area[riverside], familyFriendly[yes], near[Raja Indian Cuisine]"	Kid friendly Italian restaurant The Waterman is located near Raja Indian Cuisine in the riverside area. The price range is £20-25.
"name[The Waterman], eatType[restaurant], food[Italian], priceRange[cheap], area[riverside], familyFriendly[yes], near[Raja Indian Cuisine]"	On the riverside near Raja Indian Cuisine is a family friendly restaurant called The Waterman. It serves cheap Italian food.
"name[The Waterman], eatType[restaurant], food[Italian], priceRange[high], area[city centre], familyFriendly[no], near[Raja Indian Cuisine]"	For a high priced Italian restaurant then go to the The Waterman located near Raja Indian Cuisine in the city centre.  It is not child friendly.
"name[The Waterman], eatType[restaurant], food[Italian], priceRange[high], area[city centre], familyFriendly[yes], near[Raja Indian Cuisine]"	An Italian restaurant named The Waterman is located near Raja Indian Cuisine in the city centre. It is children friendly and has a high price range.
"name[The Waterman], eatType[restaurant], food[Italian], priceRange[high], area[riverside], familyFriendly[no], near[Raja Indian Cuisine]"	At the riverside near Raja Indian Cuisine is a Italian restaurant called The Waterman. It is not children friendly and has a high price range.
"name[The Waterman], eatType[restaurant], food[Italian], priceRange[high], area[riverside], familyFriendly[yes], near[Raja Indian Cuisine]"	"For a high priced Italian restaurant in the riverside area, try The Waterman. It is children friendly and is located near Raja Indian Cuisine."
"name[The Waterman], eatType[restaurant], food[Italian], priceRange[less than Â£20], area[city centre], familyFriendly[no], near[Raja Indian Cuisine]"	An Italian restaurant named The Waterman is located near Raja Indian Cuisine in the city centre. It is not family-friendly and has a price range of less than £20.
"name[The Waterman], eatType[restaurant], food[Italian], priceRange[less than Â£20], area[city centre], familyFriendly[yes], near[Raja Indian Cuisine]"	Italian restaurant The Waterman is located in the city centre near Raja Indian Cuisine. It is family-friendly and is in the less than £20 price range.
"name[The Waterman], eatType[restaurant], food[Italian], priceRange[less than Â£20], area[riverside], familyFriendly[no], near[Raja Indian Cuisine]"	At the riverside near Raja Indian Cuisine is a Italian restaurant called The Waterman. It is not family-friendly and has a price range of less than £20.
"name[The Wrestlers], eatType[pub], food[Italian], priceRange[less than Â£20], area[riverside], familyFriendly[no], near[Raja Indian Cuisine]"	In the riverside area near Raja Indian Cuisine is a pub called The Wrestlers. It serves Italian food for less than £20. It is not family-friendly.
"name[The Wrestlers], eatType[pub], food[Italian], priceRange[less than Â£20], area[riverside], familyFriendly[yes], near[Raja Indian Cuisine]"	At the riverside near Raja Indian Cuisine is a pub called The Wrestlers. It serves Italian food for less than £20 and is family friendly.
"name[The Wrestlers], eatType[pub], food[Italian], priceRange[moderate], area[city centre], familyFriendly[no], near[Raja Indian Cuisine]"	The Wrestlerss is a pub that serves Italian food in the moderate price range in the city centre near Raja Indian Cuisine and is not kid friendly.
"name[The Wrestlers], eatType[pub], food[Italian], priceRange[moderate], area[city centre], familyFriendly[yes], near[Raja Indian Cuisine]"	Near Raja Indian Cuisine is a pub called The Wrestlers. It serves Italian food and is kid friendly. It is in the city centre and has a moderate price range.
"name[The Wrestlers], eatType[pub], food[Italian], priceRange[moderate], area[riverside], familyFriendly[no], near[Raja Indian Cuisine]"	The The Wrestlers is a pub that serves Italian food at a moderate price range. It is not kid friendly and is located near Raja Indian Cuisine in the riverside area.
"name[The Wrestlers], eatType[pub], food[Italian], priceRange[moderate], area[riverside], familyFriendly[yes], near[Raja Indian Cuisine]"	On the riverside near Raja Indian Cuisine is a kid friendly pub called The Wrestlers. It serves Italian food and has a moderate price range.
"name[The Wrestlers], eatType[pub], food[Italian], priceRange[more than Â£30], area[riverside], familyFriendly[yes], near[Raja Indian Cuisine]"	By the riverside near Raja Indian Cuisine is a child friendly pub called The Wrestlers. It serves Italian food and has a price range of more than £30.
"name[The Wrestlers], eatType[pub], food[Japanese], priceRange[Â£20-25], area[riverside], familyFriendly[yes], near[Raja Indian Cuisine]"	On the riverside near Raja Indian Cuisine is a kid friendly pub called The Wrestlers. It serves Japanese food and has a price range of £20-25.
"name[The Wrestlers], eatType[pub], food[Japanese], priceRange[cheap], area[riverside], familyFriendly[yes], near[Raja Indian Cuisine]"	"Situated on the riverside near Raja Indian Cuisine, The Wrestlers is a family friendly pub that serves Japanese food at a cheap price."
"name[The Wrestlers], eatType[pub], food[Japanese], priceRange[high], area[riverside], familyFriendly[yes], near[Raja Indian Cuisine]"	Raja Indian Cuisine is a pub called The Wrestlers that serves Japanese food and is children friendly. It is in the high price range and is located in the riverside area.
"name[The Wrestlers], eatType[pub], food[Japanese], priceRange[less than Â£20], area[city centre], familyFriendly[no], near[Raja Indian Cuisine]"	The Wrestlers is a pub that serves Japanese food for less than £20. It is located in the city centre near Raja Indian Cuisine and is not family friendly.
"name[The Wrestlers], eatType[pub], food[Japanese], priceRange[less than Â£20], area[city centre], familyFriendly[yes], near[Raja Indian Cuisine]"	Family friendly The Wrestlers is a pub that serves Japanese food for less than £20. It is located in the city centre near Raja Indian Cuisine.
"name[The Wrestlers], eatType[pub], food[Japanese], priceRange[less than Â£20], area[riverside], familyFriendly[no], near[Raja Indian Cuisine]"	In the riverside area near Raja Indian Cuisine is a pub called The Wrestlers. It serves Japanese food for less than £20. It is not family-friendly.
"name[The Wrestlers], eatType[pub], food[Japanese], priceRange[less than Â£20], area[riverside], familyFriendly[yes], near[Raja Indian Cuisine]"	At the riverside near Raja Indian Cuisine is a pub called The Wrestlers. It serves Japanese food for less than £20 and is family friendly.
"name[The Wrestlers], eatType[pub], food[Japanese], priceRange[moderate], area[city centre], familyFriendly[no], near[Raja Indian Cuisine]"	The Wrestlerss is a pub that serves Japanese food in the moderate price range in the city centre near Raja Indian Cuisine and is not kid friendly.
"name[The Wrestlers], eatType[pub], food[Japanese], priceRange[moderate], area[city centre], familyFriendly[yes], near[Raja Indian Cuisine]"	Near Raja Indian Cuisine is a pub called The Wrestlers. It serves Japanese food and is kid friendly. It is in the city centre and has a moderate price range.
"name[The Wrestlers], eatType[pub], food[Japanese], priceRange[moderate], area[riverside], familyFriendly[no], near[Raja Indian Cuisine]"	The The Wrestlers is a pub that serves Japanese food at a moderate price range. It is not kid friendly and is located near Raja Indian Cuisine in the riverside area.
"name[The Wrestlers], eatType[pub], food[Japanese], priceRange[moderate], area[riverside], familyFriendly[yes], near[Raja Indian Cuisine]"	On the riverside near Raja Indian Cuisine is a kid friendly pub called The Wrestlers. It serves Japanese food and has a moderate price range.
"name[The Wrestlers], eatType[pub], food[Japanese], priceRange[moderate], customer rating[1 out of 5], area[city centre], familyFriendly[yes], near[Raja Indian Cuisine]"	A pub named The Wrestlers is located in the city centre near Raja Indian Cuisine. It is kid friendly and serves Japanese food at a moderate price range. It has a customer rating of 1 out of 5.
"name[The Wrestlers], eatType[pub], food[Japanese], priceRange[moderate], customer rating[1 out of 5], area[riverside], familyFriendly[no], near[Raja Indian Cuisine]"	"Rated 1 out of 5, The Wrestlers is a pub that serves Japanese food at a moderate price. It is located in the riverside area near Raja Indian Cuisine and is not kid friendly."
"name[The Wrestlers], eatType[pub], food[Japanese], priceRange[moderate], customer rating[1 out of 5], area[riverside], familyFriendly[yes], near[Raja Indian Cuisine]"	The The Wrestlers is a pub that serves Japanese food and is kids friendly. It is located near Raja Indian Cuisine in the riverside area. It has a moderate price range and a customer rating of 1 out of 5.
"name[The Wrestlers], eatType[pub], food[Japanese], priceRange[more than Â£30], area[city centre], familyFriendly[no], near[Raja Indian Cuisine]"	The The Wrestlers is a pub serving Japanese food in the city centre near Raja Indian Cuisine. It is not child friendly and has a price range of more than £30.
"name[The Wrestlers], eatType[pub], food[Japanese], priceRange[more than Â£30], area[city centre], familyFriendly[yes], near[Raja Indian Cuisine]"	The The Wrestlers is a children friendly pub serving Japanese food in the city centre near Raja Indian Cuisine. It has a price range of more than £30.
"name[The Wrestlers], eatType[pub], food[Japanese], priceRange[more than Â£30], area[riverside], familyFriendly[no], near[Raja Indian Cuisine]"	Near Raja Indian Cuisine in the riverside area is a pub called The Wrestlers. It serves Japanese food and is not children friendly. The price range is more than £30.
"name[The Wrestlers], eatType[pub], food[Japanese], priceRange[more than Â£30], area[riverside], familyFriendly[yes], near[Raja Indian Cuisine]"	By the riverside near Raja Indian Cuisine is a child friendly pub called The Wrestlers. It serves Japanese food and has a price range of more than £30.
"name[The Wrestlers], eatType[pub], food[Japanese], priceRange[more than Â£30], customer rating[5 out of 5], area[city centre], familyFriendly[no], near[Raja Indian Cuisine]"	This pub is not children friendly and is located in the city centre near Raja Indian Cuisine.  It is called The Wrestlers and serves Japanese food at a price range of more than £30. It has a customer rating of 5 out of 5.
"name[The Wrestlers], eatType[pub], food[Japanese], priceRange[more than Â£30], customer rating[5 out of 5], area[city centre], familyFriendly[yes], near[Raja Indian Cuisine]"	This children friendly pub called The Wrestlers serves Japanese food and is located in the city centre near Raja Indian Cuisine. It has a customer rating of 5 out of 5 and a price range of more than £30.
"name[The Wrestlers], eatType[pub], food[Japanese], priceRange[more than Â£30], customer rating[5 out of 5], area[riverside], familyFriendly[no], near[Raja Indian Cuisine]"	Near Raja Indian Cuisine in the riverside area is a pub called The Wrestlers. It serves Japanese food and has a customer rating of 5 out of 5. It is not children friendly and costs more than £30.
"name[The Wrestlers], eatType[pub], food[Japanese], priceRange[more than Â£30], customer rating[5 out of 5], area[riverside], familyFriendly[yes], near[Raja Indian Cuisine]"	In the riverside area near Raja Indian Cuisine is a child friendly pub called The Wrestlers. It has a 5 out of 5 customer rating and a price range of more than £30.
"name[The Wrestlers], eatType[pub], food[Japanese], priceRange[more than Â£30], customer rating[low], area[city centre], familyFriendly[no], near[Raja Indian Cuisine]"	"Located in the city centre near Raja Indian Cuisine, The Wrestlers is a pub that serves Japanese food with a price range of more than £30. It is not children friendly and has a low customer rating."
"name[The Wrestlers], eatType[pub], food[Japanese], priceRange[more than Â£30], customer rating[low], area[city centre], familyFriendly[yes], near[Raja Indian Cuisine]"	Children friendly Japanese pub The Wrestlers has a price range of more than £30 and a low customer rating. It is located in the city centre near Raja Indian Cuisine.
"name[The Wrestlers], eatType[pub], food[Japanese], priceRange[more than Â£30], customer rating[low], area[riverside], familyFriendly[no], near[Raja Indian Cuisine]"	Coffee shop The Wrestlers is a Japanese restaurant located in riverside near Raja Indian Cuisine. It has a low customer rating and is not children friendly. The price range is more than £30.
"name[The Wrestlers], eatType[pub], food[Japanese], priceRange[more than Â£30], customer rating[low], area[riverside], familyFriendly[yes], near[Raja Indian Cuisine]"	Children friendly Japanese food pub The Wrestlers has a price range of more than £30 and a low customer rating. It is located in the riverside area near Raja Indian Cuisine.
"name[The Wrestlers], eatType[restaurant], food[Italian], priceRange[less than Â£20], area[riverside], familyFriendly[no], near[Raja Indian Cuisine]"	At the riverside near Raja Indian Cuisine is a Italian restaurant called The Wrestlers. It is not family-friendly and has a price range of less than £20.
"name[The Wrestlers], eatType[restaurant], food[Italian], priceRange[less than Â£20], area[riverside], familyFriendly[yes], near[Raja Indian Cuisine]"	The The Wrestlers is a family friendly restaurant that serves Italian food for less than £20. It is located in the riverside area near Raja Indian Cuisine.
"name[The Wrestlers], eatType[restaurant], food[Italian], priceRange[moderate], area[city centre], familyFriendly[no], near[Raja Indian Cuisine]"	An Italian restaurant near Raja Indian Cuisine in the city centre is The Wrestlers. It is not kid friendly and is moderately priced.
"name[The Wrestlers], eatType[restaurant], food[Italian], priceRange[moderate], area[city centre], familyFriendly[yes], near[Raja Indian Cuisine]"	Italian restaurant The Wrestlers is located in the city centre near Raja Indian Cuisine. It is a kid friendly restaurant with a moderate price range.
"name[The Wrestlers], eatType[restaurant], food[Italian], priceRange[moderate], area[riverside], familyFriendly[no], near[Raja Indian Cuisine]"	There is a moderately priced Italian restaurant called The Wrestlers located in riverside near Raja Indian Cuisine. It is not kids friendly.
"name[The Wrestlers], eatType[restaurant], food[Italian], priceRange[moderate], area[riverside], familyFriendly[yes], near[Raja Indian Cuisine]"	Riverside restaurant The Wrestlers is a kid friendly restaurant that serves Italian food at a moderate price range. It is located near Raja Indian Cuisine.
"name[The Wrestlers], eatType[restaurant], food[Italian], priceRange[more than Â£30], area[riverside], familyFriendly[yes], near[Raja Indian Cuisine]"	"For a child friendly restaurant that serves Italian food and has a price range of more than £30, then The Wrestlers is located near Raja Indian Cuisine in the riverside area."
"name[The Wrestlers], eatType[restaurant], food[Japanese], priceRange[Â£20-25], area[riverside], familyFriendly[yes], near[Raja Indian Cuisine]"	Kid friendly Japanese restaurant The Wrestlers is located near Raja Indian Cuisine in the riverside area. The price range is £20-25.
"name[The Wrestlers], eatType[restaurant], food[Japanese], priceRange[cheap], area[riverside], familyFriendly[yes], near[Raja Indian Cuisine]"	On the riverside near Raja Indian Cuisine is a family friendly restaurant called The Wrestlers. It serves cheap Japanese food.
"name[The Wrestlers], eatType[restaurant], food[Japanese], priceRange[high], area[riverside], familyFriendly[yes], near[Raja Indian Cuisine]"	"For a high priced Japanese restaurant in the riverside area, try The Wrestlers. It is children friendly and is located near Raja Indian Cuisine."
"name[The Wrestlers], eatType[restaurant], food[Japanese], priceRange[less than Â£20], area[city centre], familyFriendly[no], near[Raja Indian Cuisine]"	An Japanese restaurant named The Wrestlers is located near Raja Indian Cuisine in the city centre. It is not family-friendly and has a price range of less than £20.
"name[The Wrestlers], eatType[restaurant], food[Japanese], priceRange[less than Â£20], area[city centre], familyFriendly[yes], near[Raja Indian Cuisine]"	Japanese restaurant The Wrestlers is located in the city centre near Raja Indian Cuisine. It is family-friendly and is in the less than £20 price range.
"name[The Wrestlers], eatType[restaurant], food[Japanese], priceRange[less than Â£20], area[riverside], familyFriendly[no], near[Raja Indian Cuisine]"	At the riverside near Raja Indian Cuisine is a Japanese restaurant called The Wrestlers. It is not family-friendly and has a price range of less than £20.
"name[The Wrestlers], eatType[restaurant], food[Japanese], priceRange[less than Â£20], area[riverside], familyFriendly[yes], near[Raja Indian Cuisine]"	The The Wrestlers is a family friendly restaurant that serves Japanese food for less than £20. It is located in the riverside area near Raja Indian Cuisine.
"name[The Wrestlers], eatType[restaurant], food[Japanese], priceRange[moderate], area[city centre], familyFriendly[no], near[Raja Indian Cuisine]"	An Japanese restaurant near Raja Indian Cuisine in the city centre is The Wrestlers. It is not kid friendly and is moderately priced.
"name[The Wrestlers], eatType[restaurant], food[Japanese], priceRange[moderate], area[city centre], familyFriendly[yes], near[Raja Indian Cuisine]"	Japanese restaurant The Wrestlers is located in the city centre near Raja Indian Cuisine. It is a kid friendly restaurant with a moderate price range.
"name[The Wrestlers], eatType[restaurant], food[Japanese], priceRange[moderate], area[riverside], familyFriendly[no], near[Raja Indian Cuisine]"	There is a moderately priced Japanese restaurant called The Wrestlers located in riverside near Raja Indian Cuisine. It is not kids friendly.
"name[The Wrestlers], eatType[restaurant], food[Japanese], priceRange[moderate], area[riverside], familyFriendly[yes], near[Raja Indian Cuisine]"	Riverside restaurant The Wrestlers is a kid friendly restaurant that serves Japanese food at a moderate price range. It is located near Raja Indian Cuisine.
"name[The Wrestlers], eatType[restaurant], food[Japanese], priceRange[more than Â£30], area[city centre], familyFriendly[no], near[Raja Indian Cuisine]"	An Japanese restaurant near Raja Indian Cuisine in the city centre is The Wrestlers. It is not child friendly and has a price range of more than £30.
"name[The Wrestlers], eatType[restaurant], food[Japanese], priceRange[more than Â£30], area[city centre], familyFriendly[yes], near[Raja Indian Cuisine]"	A children friendly Japanese restaurant named The Wrestlers is located near Raja Indian Cuisine in the city centre. It has a price range of more than £30.
"name[The Wrestlers], eatType[restaurant], food[Japanese], priceRange[more than Â£30], area[riverside], familyFriendly[no], near[Raja Indian Cuisine]"	Near Raja Indian Cuisine is a Japanese restaurant called The Wrestlers in riverside. It is not children friendly and the price range is more than £30.
"name[The Wrestlers], eatType[restaurant], food[Japanese], priceRange[more than Â£30], area[riverside], familyFriendly[yes], near[Raja Indian Cuisine]"	"For a child friendly restaurant that serves Japanese food and has a price range of more than £30, then The Wrestlers is located near Raja Indian Cuisine in the riverside area."
"name[Wildwood], eatType[coffee shop], area[riverside]"	Coffee shop Wildwood is located in the riverside area and has a customer rating of 3 out of 5.
"name[Wildwood], eatType[pub], area[riverside]"	"If you are looking for a pub in the riverside area, try Wildwood."
"name[Wildwood], eatType[pub], food[French], area[riverside], familyFriendly[yes], near[Raja Indian Cuisine]"	By the riverside near Raja Indian Cuisine is a pub called Wildwood. It serves French food and is children friendly.
"name[Wildwood], eatType[pub], food[Indian], area[city centre], familyFriendly[no], near[Raja Indian Cuisine]"	A pub near Raja Indian Cuisine in the city centre is Wildwood. It serves Indian food and is not family-friendly.
"name[Wildwood], eatType[pub], food[Indian], area[city centre], familyFriendly[yes], near[Raja Indian Cuisine]"	"Serving Indian food in a family-friendly environment, Wildwood is a pub located in the city centre near Raja Indian Cuisine."
"name[Wildwood], eatType[pub], food[Indian], area[riverside], familyFriendly[no], near[Raja Indian Cuisine]"	On the riverside near Raja Indian Cuisine is a pub called Wildwood. It serves Indian food and is not family-friendly.
"name[Wildwood], eatType[pub], food[Indian], area[riverside], familyFriendly[yes], near[Raja Indian Cuisine]"	By the riverside near Raja Indian Cuisine is a pub called Wildwood. It serves Indian food and is children friendly.
"name[Wildwood], eatType[pub], food[Italian], area[city centre], familyFriendly[no], near[Raja Indian Cuisine]"	A pub near Raja Indian Cuisine in the city centre is Wildwood. It serves Italian food and is not family-friendly.
"name[Wildwood], eatType[pub], food[Italian], area[city centre], familyFriendly[yes], near[Raja Indian Cuisine]"	"Serving Italian food in a family-friendly environment, Wildwood is a pub located in the city centre near Raja Indian Cuisine."
"name[Wildwood], eatType[pub], food[Italian], area[riverside], familyFriendly[no], near[Raja Indian Cuisine]"	On the riverside near Raja Indian Cuisine is a pub called Wildwood. It serves Italian food and is not family-friendly.
"name[Wildwood], eatType[pub], food[Italian], area[riverside], familyFriendly[yes], near[Raja Indian Cuisine]"	By the riverside near Raja Indian Cuisine is a pub called Wildwood. It serves Italian food and is children friendly.
"name[Wildwood], eatType[restaurant], food[French], area[riverside], familyFriendly[yes], near[Raja Indian Cuisine]"	Children friendly French restaurant Wildwood is located in riverside near Raja Indian Cuisine.
"name[Wildwood], eatType[restaurant], food[Indian], area[city centre], familyFriendly[no], near[Raja Indian Cuisine]"	"Serving Indian food, Wildwood is a restaurant near Raja Indian Cuisine in the city centre. It is not family-friendly."
"name[Wildwood], eatType[restaurant], food[Indian], area[city centre], familyFriendly[yes], near[Raja Indian Cuisine]"	Children friendly Wildwood restaurant serves Indian food and is located in the city centre near Raja Indian Cuisine.
"name[Wildwood], eatType[restaurant], food[Indian], area[riverside], familyFriendly[no], near[Raja Indian Cuisine]"	Wildwood is a restaurant that serves Indian food in the riverside area near Raja Indian Cuisine. It is not family friendly.
"name[Wildwood], eatType[restaurant], food[Indian], area[riverside], familyFriendly[yes], near[Raja Indian Cuisine]"	Children friendly Indian restaurant Wildwood is located in riverside near Raja Indian Cuisine.
"name[Wildwood], eatType[restaurant], food[Italian], area[city centre], familyFriendly[no], near[Raja Indian Cuisine]"	"Serving Italian food, Wildwood is a restaurant near Raja Indian Cuisine in the city centre. It is not family-friendly."
"name[Wildwood], eatType[restaurant], food[Italian], area[city centre], familyFriendly[yes], near[Raja Indian Cuisine]"	Children friendly Wildwood restaurant serves Italian food and is located in the city centre near Raja Indian Cuisine.
"name[Wildwood], eatType[restaurant], food[Italian], area[riverside], familyFriendly[no], near[Raja Indian Cuisine]"	Wildwood is a restaurant that serves Italian food in the riverside area near Raja Indian Cuisine. It is not family friendly.
"name[Wildwood], eatType[restaurant], food[Italian], area[riverside], familyFriendly[yes], near[Raja Indian Cuisine]"	Children friendly Italian restaurant Wildwood is located in riverside near Raja Indian Cuisine.
"name[Zizzi], eatType[coffee shop], area[riverside]"	Coffee shop Zizzi is located in the riverside area and has a customer rating of 3 out of 5.
"name[Zizzi], eatType[coffee shop], customer rating[average], near[Burger King]"	"If you are looking for a coffee shop with an average customer rating, try Zizzi. It is located near Burger King."
"name[Zizzi], eatType[coffee shop], customer rating[high], near[Burger King]"	"If you are looking for a highly rated coffee shop near Burger King, try Zizzi."
"name[Zizzi], eatType[coffee shop], near[The Sorrento]"	Coffee shop called Zizzi is near The Sorrento.
"name[Zizzi], eatType[pub], area[riverside]"	"If you are looking for a pub in the riverside area, try Zizzi."
"name[Zizzi], eatType[pub], customer rating[average], near[Burger King]"	"If you are looking for a pub near Burger King, try Zizzi. It has an average customer rating."
"name[Zizzi], eatType[pub], customer rating[high], near[Burger King]"	"Check out Zizzi, a pub near Burger King. It has a high customer rating."
"name[Zizzi], eatType[pub], near[The Sorrento]"	"If you are looking for a pub near The Sorrento, try Zizzi."
